0;0;0;0;0;0;0;0;0;0;0;0;0;0;0;0;0;0;0;0;0;0;0;0;0;0;0;0;0;0;0;0;0;0;0;A;A;A;A;A
0;0;0;0;0;0;0;0;0;0;0;0;0;0;0;0;0;0;0;0;0;0;0;0;0;0;0;0;0;0;0;0;0;0;0;0;A;A;A;A
0;0;0;0;0;0;0;0;0;0;0;0;0;0;0;0;0;0;0;0;0;0;0;0;0;0;0;0;0;0;0;0;0;0;0;0;0;0;0;0
0;0;0;0;0;0;0;0;0;0;0;0;0;0;0;0;0;0;0;0;0;0;0;0;0;0;0;0;0;0;0;0;0;0;0;0;0;0;0;0
0;0;0;0;0;0;0;0;0;0;0;0;0;0;0;0;0;0;0;0;0;0;0;0;0;0;0;0;0;0;0;0;0;0;0;0;0;0;0;0
0;0;0;0;0;0;0;0;0;0;0;0;0;0;0;0;0;0;0;0;0;0;0;0;0;0;0;0;0;0;0;0;0;0;0;0;0;0;0;0
0;0;0;0;0;0;0;0;0;0;0;0;0;0;0;0;0;0;0;0;0;0;0;0;0;0;0;0;0;0;0;0;0;0;0;0;C;C;C;A
0;0;0;0;0;0;0;0;0;0;0;0;0;0;0;0;0;0;0;0;0;0;0;0;0;0;0;0;0;0;0;0;0;0;0;0;C;C;A;A
0;0;0;0;0;0;0;0;0;0;0;0;0;0;0;0;0;0;0;0;0;0;0;0;0;0;0;0;0;0;0;0;0;0;0;0;A;A;A;A
0;0;0;0;0;0;0;0;0;0;0;0;0;0;0;0;0;0;0;0;0;0;0;0;0;0;0;0;0;0;0;0;0;0;0;0;A;A;A;A
0;0;0;0;0;0;0;0;0;0;0;0;0;0;0;0;0;0;0;0;0;0;0;0;0;0;0;0;0;0;0;0;0;0;0;0;A;A;A;A
0;0;0;0;0;0;0;0;0;0;C;C;C;0;0;0;0;0;0;0;0;0;0;0;0;0;0;0;0;0;0;0;0;0;0;0;A;A;A;A
0;0;0;0;0;0;0;0;0;C;C;C;C;0;0;0;0;0;0;0;0;0;0;0;0;0;0;0;0;0;0;0;0;0;0;0;A;A;A;A
0;0;0;0;0;0;0;0;0;C;C;C;C;C;0;0;0;0;0;0;0;0;0;0;0;C;C;0;0;0;0;0;0;0;0;0;A;A;A;A
0;0;0;0;0;0;0;0;0;C;C;C;C;C;0;0;0;0;0;0;0;0;0;0;C;C;C;0;0;0;0;0;0;0;0;0;A;A;A;A
0;0;0;0;0;0;0;0;0;A;A;A;C;C;0;0;0;0;0;0;0;0;0;0;C;C;C;0;0;0;0;0;0;0;0;0;0;A;A;A
0;0;0;0;0;0;0;0;0;A;A;A;A;A;0;0;0;0;0;0;0;0;A;A;C;C;C;0;0;0;0;0;0;0;0;0;0;A;A;A
0;0;0;0;0;0;0;0;A;A;A;A;A;A;0;0;0;0;0;0;0;0;A;A;C;C;C;0;0;0;0;0;0;0;0;0;0;0;A;A
A;A;A;A;A;A;A;A;A;A;A;A;A;A;0;0;0;0;0;0;0;0;A;A;A;A;A;0;0;0;0;0;0;0;0;0;0;0;A;A
A;A;A;A;A;A;A;A;A;A;A;A;A;A;A;0;0;0;0;0;A;A;A;A;A;A;A;A;0;0;0;0;0;0;0;0;0;0;A;A
A;A;A;A;A;A;A;A;A;A;A;A;A;A;A;A;A;A;A;A;A;A;A;A;A;A;A;A;0;0;0;0;0;0;0;0;0;0;A;A
A;A;A;A;A;A;A;A;A;A;A;A;A;A;A;A;A;A;A;A;A;A;A;A;A;A;A;A;A;0;0;0;0;0;0;0;0;0;A;A
A;A;A;A;A;A;A;A;A;A;A;A;A;A;A;A;A;A;A;A;A;A;A;A;A;A;A;A;A;0;0;0;0;0;0;0;0;0;A;A
