1 1 1 1 1 1 1 1 1 1 1 1 1 1 1 1 1 1 1 1 1 1 1 1 1 1 1 1 1 1 1 1 1 1 1 1 1 1 1 1
1 0 0 0 0 0 0 0 0 0 0 0 0 0 0 0 0 0 0 0 0 0 0 0 0 0 0 0 0 0 0 0 0 0 0 0 0 0 0 1
1 0 _ S 0 > 1 1 S B _ B B Q ^ R O O O O W O C Q ^ 0 < O > L ^ L < > F v L 0 > <
1 0 D 1 L O F L Q 0 ^ 1 Q 0 > B C D > 0 B v B D S Q ^ 0 D 0 C W W _ Q W L F C 0
1 0 < O B > F < _ > F C D C F D D B v L v B R W L W C _ _ R Q B C > _ 0 Q F B R
1 0 F _ D 0 B R L v C D L 1 _ F Q 0 > W L O < _ < B v R B < Q _ 0 1 D L 0 ^ C >
0 0 ^ ^ R W 0 0 L B > < _ D 0 R v D 1 v S B D R W C Q L v W > O L v v < D < 1 0
0 0 0 v D v O 0 B B Q W _ ^ S B D B S v O _ S F Q R v D < v C 1 Q 1 > O 0 B 0 0
0 0 0 0 v 0 L 0 F 0 B Q C S O F F L R Q D _ B v _ D F 1 _ W W B _ W F > 0 0 0 0
0 0 P 0 v B R _ F D 0 Q C R S F ^ 0 L L S 1 C Q C R D L 0 ^ Q > > ^ W v 0 P 0 0
0 0 0 0 D Q R F F R S > R W 0 S C B L 0 F 1 W W < v B Q B 1 F D O > > B 0 0 0 0
1 0 ^ 1 v B R B D 0 > O 1 R S < S v D _ _ C < D S O B L > v v Q S _ W S ^ v S v
1 0 L v ^ 0 > O L W 0 _ Q L Q Q _ Q > R < 1 Q R > _ < L R v R F > ^ B _ D v D W
1 0 v C R 0 < 0 ^ S F < > ^ ^ < F 1 F Q 0 W C v C v _ ^ Q O Q C C O Q 1 Q B F O
1 0 v C D ^ W 0 Q C D B Q 0 ^ < L L B D _ R _ 0 F C R F 0 Q S L v B D 0 F F F v
1 0 S F S D 0 F D _ D < B C F _ 1 C R O 1 L Q R 1 > W D D 1 W W _ O _ S R < B S
1 0 S D ^ D _ B R 0 B B 1 _ > C 1 > S < S 0 W 1 L > R C Q S O C L W L 1 L B C >
1 0 _ ^ F < v F Q R O < O C > D < < _ L 1 B _ 0 > < > C R D S L > ^ D D Q > > C
1 0 _ 1 _ Q 0 D 0 R C F O O ^ S 1 F B < 1 0 W B R B W W C < ^ S Q v Q > O < 0 1
1 0 S S D R 1 R L S 1 S C ^ 0 F D _ O < R B W < S ^ R ^ R _ F ^ R C 0 Q C v > F
1 0 D F S D < B W S B W < D O S S < L > 0 L D R 0 ^ > S L > L < L R O C O v F B
1 0 W F L L 0 1 _ L C ^ 0 O < S C _ L > > R < L > R ^ _ S ^ v B C L R R R ^ F L
1 1 < C < Q _ R C D L 1 1 S C v F R Q R R Q O O B L ^ R B 1 W S O D C R ^ B D L
