1 1 1 1 1 1 1 1 1 1 1 1 1 1 1 1 1 1 1 1 1 1 1 1 1 1 1 1 1 1 1 1 1 1 1 1 1 1 1 1
1 0 0 0 0 0 0 0 0 0 0 0 0 0 0 0 0 0 0 0 0 0 0 0 0 0 0 0 0 0 0 0 0 0 0 0 0 0 0 1
1 0 F C D F > D B v W D D L 0 W L R 1 Q W 0 ^ W L F L O ^ Q Q R C ^ Q F _ B v Q
1 0 > 1 F > B R O v C F W _ < v F B D v 0 B ^ D > F O L > Q < S 0 S W < O Q 0 0
1 0 D L 1 S 1 S L F C W S 0 R R C Q B Q B O 1 1 W S O 0 > D L O D D < F ^ B O B
1 0 R S B Q < < W ^ R _ _ C C R C Q W Q _ D B 0 1 1 _ O Q L > W v L < 0 v 0 1 >
0 0 Q D Q R L 0 O ^ 0 > C F _ < Q F _ ^ L 1 > _ _ O Q C O > B 1 1 F Q L > ^ S 0
0 0 < 1 O ^ D v W O O D v W > v F Q < > < v R Q ^ ^ F v > C O D > ^ S ^ O R F 0
0 0 0 0 R L ^ D ^ F _ 0 R F L _ C _ 1 C W 1 D 0 Q v C C W R Q F C 0 O D 0 0 0 0
0 0 P 0 O O Q Q D B R R L F D F Q F D Q W B W L _ O S B _ < O > R R W D 0 P 0 0
0 0 0 0 1 W B ^ R C F R _ S S > Q v O W C v R O _ L B > Q D < 0 S v 0 < 0 0 0 0
1 0 F > F S B R C R R > > R ^ O 0 Q W C W S > Q D F ^ F D Q W C F _ S L O _ 1 ^
1 0 S _ B L 0 > F 1 0 > 0 v B L _ F < 1 _ W Q O > C Q R L 0 Q L S F R D L v B W
1 0 L C > v 0 v 1 S D R < Q L ^ L S _ D L < > B 1 ^ 1 S D v 1 Q _ B O C C O D ^
1 0 L < _ 0 S L B S W F W 0 B 1 C Q S v Q Q O B > B 1 R 0 W Q R < v v v < 1 L S
1 0 D Q B O 0 Q C v C R < B > 0 ^ > 1 1 C B < 1 0 D v B Q R 0 1 > F B W S ^ D >
1 0 S ^ L D 1 ^ 1 0 C v Q R 0 F 0 R O R Q ^ Q F Q W v W v > F _ _ L O R _ W < <
1 0 ^ > _ F C 1 ^ S R W O O 1 > O ^ > S L R Q v B 0 B C D B < ^ 0 D L L W ^ _ R
1 0 D 0 1 0 C D L > B C C S O C S ^ O B R O F C W B F D > F S F < 0 Q B 0 < > S
1 0 F R D v F v D < 1 0 0 0 L 1 O O D W L 1 ^ > Q < < Q Q S O C 0 0 < B O D O D
1 0 ^ Q 1 L D W F O ^ D _ R S v > W 0 > L S R C v Q O 1 0 0 1 0 B R O W B S O F
1 0 O v 1 O _ ^ ^ v R 1 C W S v D S R F S > L L > W 0 L R ^ B C 1 v F C > B 1 O
1 1 O > W B v 0 1 S v _ R B W D < _ L < S O B O O 0 S Q F D S S R v C _ 1 Q L O
