1 1 1 1 1 1 1 1 1 1 1 1 1 1 1 1 1 1 1 1 1 1 1 1 1 1 1 1 1 1 1 1 1 1 1 1 1 1 1 1
1 0 0 0 0 0 0 0 0 0 0 0 0 0 0 0 0 0 0 0 0 0 0 0 0 0 0 0 0 0 0 0 0 0 0 0 0 0 0 1
1 0 > R F < R < B > Q Q < F Q L 1 C S W R B F v L 1 B < v O B _ B W L F v C L F
1 0 W B 0 D B 1 _ 1 < < D D F v B L S C C Q 1 ^ O > 0 O C > S 0 0 C Q R F v R O
1 0 Q C S R _ B L 1 Q 1 B C L _ < D < Q B 1 R < W W O v S O O C _ 0 O > L < _ Q
1 0 B F 0 L B _ Q > D ^ B ^ O O L > D L S R F 0 C _ D ^ 0 > R R B ^ 0 W B R > R
0 0 D F 1 B F D 1 v < D F B < W > _ L _ 1 _ F L R v O Q C D _ F C ^ 1 Q R F O 0
0 0 C ^ > R O L W _ 1 F 0 R ^ v L B F < F C < 1 _ D B Q v _ v > ^ < D _ W 1 1 0
0 0 0 0 < R D D O ^ < W B R F C Q O S 0 C O S L L B ^ 0 W W 1 _ Q O < W 0 0 0 0
0 0 P 0 F B R 0 v L B S C _ < > ^ S W 1 _ W < W S W v S S 1 B O ^ D W < 0 P 0 0
0 0 0 0 ^ _ L S Q < _ > W F O O ^ ^ C O 1 W < 1 > < C > O O ^ ^ 1 ^ O B 0 0 0 0
1 0 v 0 R O B B F R R W L v R F B R F L O _ L S > L ^ L 0 _ 1 _ R < R 1 0 D C C
1 0 S F R D Q R O 1 R L D L ^ 1 < L 0 0 > 0 < v B 0 < 1 L 0 > C > L Q D C ^ v 1
1 0 _ O > 1 B Q B D O R C D v D > 0 > C v 1 B v _ R B R _ Q > D R < C S O > L 0
1 0 < O > L _ W 0 v v C ^ D B C > _ D O D B C 1 C C 0 R D R W S _ _ ^ D S W > W
1 0 0 W Q < 1 v C v _ > 0 D < R R v S O C 0 F > F ^ W 0 W ^ F < 1 C R 0 v O O >
1 0 C W S F v L S v 1 W O _ W ^ Q R R F W F D O R 0 _ L ^ F C 0 0 B W F v C F W
1 0 C ^ 0 O F R < v > L _ _ B D F D 1 B < S v v 0 W B S W 0 v F W Q R > C L D >
1 0 R v F D F 1 < ^ W 0 S O 0 R 0 F S _ Q O 1 < W < D C < D C Q ^ W F _ Q < > >
1 0 R R D v F < W W 1 > 0 R F 1 1 L v F < Q Q L < 0 W B D B D S D 1 Q S W > D W
1 0 F _ ^ _ 0 O S D 1 S ^ v v ^ D _ B ^ < 1 _ S < > 1 _ 1 0 C O 1 L R 1 W D W L
1 0 D B _ W O C L v ^ O ^ 1 F F < 0 O R _ O L B F _ F O C Q Q B ^ W > L L Q O Q
1 1 < Q 0 < ^ O S _ _ > F C _ L L C F B W 1 O ^ R > ^ v B v ^ v C 1 W v B O D O
