u;u;u;u;u;u;u;u;u;u;u;u;u;u;u;u;u;u;u;u;u;u;u;u;u;u;u;u;u;u;u;u;u;u;u;u;u;u;u;u;u;u;u;u;u;u;u;u;u;u;u;u;u;u;u;u;u;u;u;u
u;u;u;u;u;u;u;u;0;0;0;0;0;0;0;0;0;0;0;0;0;0;0;0;0;u;0;0;0;0;0;0;0;0;0;0;0;0;0;0;0;0;0;0;0;0;0;0;0;0;0;0;0;u;u;u;u;u;u;u
u;u;u;u;u;u;u;u;0;0;0;0;0;0;0;0;0;0;0;0;0;0;0;0;0;u;0;0;0;0;0;0;0;0;0;0;0;0;0;0;0;0;0;0;0;0;0;0;0;0;0;0;0;u;u;u;u;u;u;u
u;u;u;u;u;u;u;u;0;0;0;0;0;0;0;0;0;0;0;0;0;0;0;0;0;u;0;0;0;0;0;0;0;0;0;0;0;0;0;0;0;0;0;0;0;0;0;0;0;0;0;0;0;u;u;u;u;u;u;u
u;u;u;u;u;u;u;u;0;0;0;0;0;0;0;0;0;0;0;0;0;0;0;0;0;u;0;0;0;0;0;0;0;0;0;0;0;0;0;0;0;0;0;0;0;0;0;0;0;0;0;0;0;0;0;u;u;u;u;u
u;u;u;u;u;u;u;u;0;0;0;0;0;0;0;0;0;0;0;0;0;0;0;0;0;u;0;0;0;0;0;0;0;0;0;0;0;0;0;0;0;0;0;0;0;0;0;0;0;0;0;0;0;0;0;0;0;u;u;u
u;u;u;u;u;u;u;u;0;0;0;0;0;0;0;0;0;0;0;0;0;0;0;0;0;u;0;0;0;0;0;0;0;0;0;0;0;0;0;0;0;0;0;0;0;0;0;0;0;0;0;0;0;0;0;0;0;0;0;0
u;u;u;u;u;0;0;0;0;0;0;0;0;0;0;0;0;0;0;0;0;0;0;0;0;u;0;0;0;0;0;0;0;0;0;0;0;0;0;0;0;0;0;0;0;0;0;0;0;0;0;0;0;0;0;0;0;0;0;0
0;0;0;0;0;0;0;0;0;0;0;0;0;0;0;0;0;0;0;0;0;0;0;0;0;u;0;0;0;0;0;0;0;0;0;0;0;0;0;0;u;u;u;u;u;u;0;0;0;0;0;0;0;0;0;0;0;0;0;0
0;0;0;0;0;0;0;0;0;0;0;0;0;0;0;0;0;0;0;0;0;0;0;0;0;u;0;0;0;0;0;0;0;0;0;0;0;0;0;0;u;u;u;u;u;u;0;0;0;0;0;0;0;0;0;0;0;0;0;0
0;0;0;0;0;0;0;0;0;0;0;0;0;0;0;0;0;0;0;0;0;0;0;0;0;u;0;0;0;0;0;0;0;0;0;0;0;0;0;0;u;u;u;u;u;u;0;0;0;0;0;0;0;u;u;u;u;u;u;u
0;0;0;0;0;0;0;0;0;0;0;0;0;0;0;0;0;0;0;0;0;0;0;0;0;u;0;0;0;0;0;0;0;0;0;0;0;0;0;0;u;u;u;u;u;u;0;0;0;0;0;0;0;u;u;u;u;u;u;u
0;0;0;0;0;0;0;0;0;0;0;0;0;0;0;0;0;0;0;0;0;0;0;0;0;u;0;0;0;0;0;0;0;0;0;0;0;0;0;0;u;u;u;u;u;u;0;0;0;0;0;0;0;u;u;u;u;u;u;u
u;u;u;u;u;u;u;u;0;0;0;0;0;0;0;0;0;0;0;0;0;0;0;0;0;u;0;0;0;0;0;0;0;0;0;0;0;0;0;0;u;u;u;u;u;u;0;0;0;0;0;0;0;u;u;u;u;u;u;u
u;u;u;u;u;u;u;u;0;0;0;0;0;0;0;0;0;0;0;0;0;0;0;0;0;0;0;0;0;0;0;0;0;0;0;0;0;0;0;0;u;u;u;u;u;u;0;0;0;0;0;0;0;u;u;u;u;u;u;u
u;u;u;u;u;u;u;u;0;0;0;0;0;0;0;0;0;0;0;0;0;0;0;0;0;0;0;0;0;0;0;0;0;0;0;0;0;0;0;0;u;u;u;u;u;u;0;0;0;0;0;0;0;u;u;u;u;u;u;u
u;u;u;u;u;u;u;u;0;0;0;0;0;0;0;0;0;0;0;0;0;0;0;0;0;0;0;0;0;0;0;0;0;0;0;0;0;0;0;0;u;u;u;u;u;u;0;0;0;0;0;0;0;u;u;u;u;u;u;u
u;u;u;u;u;u;u;u;0;0;0;0;0;0;0;0;0;0;0;0;0;0;0;0;0;0;0;0;0;0;0;0;0;0;0;0;0;0;0;0;0;0;0;0;0;0;0;0;0;0;0;0;0;u;u;u;u;u;u;u
u;u;u;u;u;u;u;u;0;0;0;0;0;0;0;0;0;0;0;0;0;0;0;0;0;0;0;0;0;0;0;0;0;0;0;0;0;0;0;0;0;0;0;0;0;0;0;0;0;0;0;0;0;u;u;u;u;u;u;u
u;u;u;u;u;u;u;u;0;0;0;0;0;0;0;0;0;0;0;0;0;0;0;0;0;0;0;0;0;0;0;0;0;0;0;0;0;0;0;0;0;0;0;0;0;0;0;0;0;0;0;0;0;u;u;u;u;u;u;u
u;u;u;u;u;u;u;u;0;0;0;0;0;0;0;0;0;0;0;0;0;0;0;0;0;0;0;0;0;0;0;0;0;0;0;0;0;0;0;0;0;0;0;0;0;0;0;0;0;0;0;0;0;u;u;u;u;u;u;u
u;u;u;u;u;u;u;u;0;0;0;0;0;0;0;0;0;0;0;0;0;0;0;0;0;0;0;0;0;0;0;0;0;0;0;0;0;0;0;0;0;0;0;0;0;0;0;0;0;0;0;0;0;u;u;u;u;u;u;u
u;u;u;u;u;u;u;u;0;0;0;0;0;0;0;0;0;0;0;0;0;0;0;0;0;0;0;0;0;0;0;0;0;0;0;0;0;0;0;0;0;0;0;0;0;0;0;0;0;0;0;0;0;u;u;u;u;u;u;u
