$;$;$;$;$;$;$;$;$;$;$;$;$;$;$;$;$;$;$;$;$;$;$;$
$;$;$;$;$;$;$;$;$;$;$;$;$;$;$;$;$;$;$;$;$;$;$;$
$;$;$;$;$;$;$;$;$;$;$;$;$;$;$;$;$;$;$;$;$;$;$;$
$;$;$;$;$;$;$;$;$;$;$;$;$;$;$;$;$;$;$;$;$;$;$;$
$;$;$;$;$;$;$;$;$;$;$;$;$;$;$;$;$;$;$;$;$;$;$;$
$;$;$;$;$;$;$;$;$;$;$;$;$;#;#;#;#;#;$;$;$;$;$;$
$;$;$;$;$;$;$;$;$;$;$;$;$;#;#;#;#;#;$;$;$;$;$;$
$;$;$;$;$;$;$;$;$;$;#;#;#;#;#;#;#;#;$;$;$;$;$;$
$;$;$;$;$;$;$;$;$;$;#;#;#;#;#;#;$;$;$;$;$;$;$;$
$;$;$;$;$;$;$;$;$;$;#;#;#;#;#;#;$;$;$;$;$;$;$;$
