7;7;7;7;7;7;7;7;7;7;7;7;7;7;7;7;7;7;7;7;7;7;7;7;7;7;7;7;7;7;7;7;7;7;4;0;0;0;0;7;7;7;7
7;7;7;7;7;7;7;7;7;7;7;7;7;7;4;7;0;0;0;0;0;0;0;0;0;7;7;7;7;7;7;7;7;7;4;0;0;0;0;7;7;7;7
7;7;7;7;7;7;7;7;7;7;7;7;0;0;4;0;0;0;0;0;0;0;0;0;0;7;7;7;7;7;7;7;7;7;4;0;0;0;0;7;7;7;7
7;7;7;7;7;7;7;7;7;7;7;7;0;0;4;0;0;0;0;0;0;0;0;0;0;0;7;7;7;7;7;7;7;7;4;0;0;0;0;7;7;7;7
7;7;7;7;7;7;7;7;7;7;7;0;0;0;4;0;0;0;0;0;0;0;0;0;0;0;7;7;7;7;7;7;7;7;4;0;0;0;0;7;7;7;7
7;7;7;7;7;7;7;7;7;7;3;3;0;0;4;0;0;0;0;0;0;0;0;0;0;0;3;3;3;7;7;7;7;7;4;0;0;0;0;7;7;7;7
7;7;7;7;7;7;7;7;7;7;3;3;3;0;4;0;0;0;0;0;0;0;0;0;0;0;3;3;3;3;7;7;7;7;4;0;0;0;0;7;7;7;7
7;7;7;7;7;7;7;7;7;7;4;4;4;4;4;0;0;0;0;0;0;0;0;0;0;0;3;3;3;3;7;7;7;7;4;0;0;0;0;7;7;7;7
7;7;7;7;7;7;7;7;7;7;7;0;0;0;0;0;0;0;0;0;0;0;0;0;0;0;3;3;3;3;7;7;7;7;4;0;0;0;0;7;7;7;7
7;7;7;7;7;7;7;7;7;7;7;0;0;0;0;0;0;0;0;0;7;7;0;0;0;0;3;3;3;7;7;7;7;7;4;0;0;0;0;7;7;7;7
7;7;7;7;7;7;7;7;7;7;7;0;0;0;0;0;0;0;0;0;7;7;0;0;0;0;3;7;7;7;7;7;7;7;4;0;0;0;0;7;7;7;7
7;7;7;7;7;7;7;7;7;7;7;0;0;0;0;0;0;0;0;0;7;7;0;0;0;0;7;7;7;7;7;7;7;7;4;0;0;0;0;7;7;7;7
7;7;7;7;7;7;7;7;7;7;7;0;0;0;0;0;0;0;0;0;7;7;0;0;0;0;7;7;7;7;7;7;7;7;4;0;0;0;0;7;7;7;7
7;7;7;7;7;7;7;7;7;7;7;0;0;0;0;0;0;0;0;0;7;7;0;0;7;7;7;7;7;7;7;7;7;7;4;0;0;0;0;7;7;7;7
7;7;7;7;7;7;7;7;7;7;7;0;0;0;0;0;0;0;0;0;7;7;0;0;7;7;7;7;7;7;7;0;0;7;4;0;0;0;0;7;7;7;7
7;7;7;7;7;7;7;7;0;0;0;0;0;0;0;0;0;0;0;0;7;7;0;0;0;0;0;0;0;0;0;0;0;7;4;0;0;0;0;7;7;7;7
7;7;7;7;7;0;0;0;0;0;0;0;0;0;0;0;0;0;0;0;7;7;0;0;0;0;0;0;0;0;0;0;0;0;4;0;0;0;0;7;7;7;7
7;0;0;0;0;0;0;0;0;0;0;0;0;0;0;0;0;0;0;0;7;7;0;0;0;0;0;0;0;0;0;0;0;0;0;0;0;0;0;0;0;0;7
7;0;0;0;0;0;0;0;0;0;0;0;0;0;0;0;0;0;0;0;7;7;0;0;0;0;0;0;0;0;0;0;0;0;0;0;0;0;0;0;0;0;7
7;0;0;0;0;0;0;0;0;0;0;0;0;0;0;0;0;0;0;0;7;7;0;0;0;0;0;0;0;0;0;0;0;0;0;0;0;0;0;0;0;0;7
7;0;0;0;0;3;3;0;0;0;0;0;0;0;0;0;0;0;0;0;7;1;0;0;0;0;0;0;0;0;0;0;0;0;0;0;0;0;0;0;0;0;7
7;0;0;0;0;3;3;0;0;0;0;0;0;0;0;0;0;0;0;0;1;1;0;0;0;0;0;0;0;0;0;0;0;0;0;0;0;0;0;0;0;0;7
7;0;0;0;0;7;7;7;7;7;0;0;0;0;0;0;0;0;0;0;1;1;0;0;0;0;0;0;0;0;0;0;0;0;0;0;0;0;0;0;0;0;7
