s;s;s;s;s;s;s;s;s;s;s;s;s;s;s;s;s;s;s;s;s;s;s;s;s;s;s;s;s;s;s;s;s;s;s;s;s;s;s;s;s;s;s;s;s;s;s;s;s;s;s;s;s;s;s;s;s;s;s;s;s;s;s;s;s;s;s;s;s;s;s;s;s;s;s;s;s;s;s;s
s;s;s;s;s;s;s;s;s;s;s;s;s;s;s;s;s;s;s;s;s;s;s;s;s;s;s;s;s;s;s;s;0;0;s;s;s;s;s;s;s;s;0;0;0;s;s;s;s;s;s;s;s;s;s;s;s;s;s;s;s;s;s;s;s;s;s;s;s;s;s;s;s;s;s;s;s;s;s;s
s;s;s;s;s;s;s;s;s;s;s;s;s;s;s;s;#;#;#;s;s;s;s;s;s;s;s;s;s;s;s;0;0;0;0;s;s;s;s;s;s;s;0;0;0;s;s;s;s;s;#;#;s;s;s;s;s;s;s;s;s;s;s;0;0;0;s;s;s;s;s;0;0;s;s;s;s;s;s;s
s;s;s;s;s;s;s;s;s;s;s;s;s;s;s;s;s;#;#;#;#;s;s;s;s;s;s;s;s;s;s;0;0;0;0;s;s;s;s;s;s;s;s;s;s;s;s;s;s;s;#;#;#;s;s;s;s;s;s;s;s;s;s;0;0;0;s;s;s;s;s;0;0;s;s;s;s;s;s;s
s;s;s;s;s;s;s;s;s;s;s;s;s;s;s;s;s;s;#;#;0;0;0;0;0;0;0;0;0;0;0;0;0;0;0;0;0;0;0;0;0;0;0;0;0;0;0;0;0;0;0;0;0;0;0;0;0;0;0;0;0;0;0;0;0;0;0;0;s;s;s;0;0;s;s;s;s;s;s;s
s;s;s;s;s;s;s;s;s;s;s;s;s;s;s;s;s;s;s;0;0;0;0;0;0;0;0;0;0;0;0;0;0;0;0;0;0;0;0;0;0;0;0;0;0;0;0;0;0;0;0;0;0;0;0;0;0;0;0;0;0;0;0;0;0;0;0;0;s;s;s;0;0;s;s;s;s;s;s;s
s;s;s;s;s;s;s;s;s;s;s;s;s;s;s;s;s;s;s;0;0;0;0;0;0;0;0;0;0;0;0;0;0;0;0;0;0;0;0;0;0;0;0;0;0;0;0;0;0;0;0;0;0;0;0;0;0;0;0;0;0;0;0;0;0;0;0;0;0;0;0;0;0;s;s;s;s;s;s;s
s;s;s;s;s;s;s;s;s;s;s;s;s;s;s;s;s;s;s;0;0;0;0;0;0;0;0;0;0;0;0;0;0;0;0;0;0;0;0;0;0;0;0;0;0;0;0;0;0;0;0;0;0;0;0;0;0;0;0;0;0;0;0;0;0;0;0;0;0;0;0;0;0;s;s;s;s;s;s;s
s;s;s;s;s;s;s;s;s;s;s;s;s;s;s;s;s;s;s;0;0;0;0;0;0;0;0;0;0;0;0;0;0;0;0;0;0;0;0;0;0;0;0;0;0;0;0;0;0;0;0;0;0;0;0;0;0;0;0;0;0;0;0;0;0;0;0;0;0;0;0;0;0;s;s;s;s;s;s;s
s;s;s;s;s;s;s;s;s;s;s;s;s;s;s;s;s;s;s;0;0;0;0;0;0;0;0;0;0;0;0;0;0;0;0;0;0;0;0;0;0;0;0;0;0;0;0;0;0;0;0;0;0;0;0;0;0;0;0;0;0;0;0;0;0;0;0;0;0;0;0;0;0;0;0;0;s;s;s;s
s;s;s;s;s;s;s;s;s;s;s;s;s;s;s;s;s;s;s;0;0;0;0;0;0;0;0;0;0;0;0;0;0;0;0;0;0;0;0;0;0;0;0;0;0;0;0;0;0;0;0;0;0;0;0;0;0;0;0;0;0;0;0;0;0;0;0;0;0;0;0;0;0;0;0;0;s;s;s;s
s;s;s;s;s;s;s;s;s;s;s;s;s;s;s;s;s;s;s;0;0;0;0;0;0;0;0;0;0;0;0;0;0;0;0;0;0;0;0;0;0;0;0;0;0;0;0;0;0;0;0;0;0;0;0;0;0;0;0;0;0;0;0;0;0;0;0;0;0;0;0;0;0;s;s;s;s;s;s;s
s;s;s;s;s;s;s;s;s;s;s;s;s;s;s;s;s;s;s;0;0;0;0;0;0;0;0;0;0;0;0;0;0;0;0;0;0;0;0;0;0;0;0;0;0;0;0;0;0;0;0;0;0;0;0;0;0;0;0;0;0;0;0;0;0;0;0;0;0;0;0;0;0;s;s;s;s;s;s;s
s;s;s;s;s;s;s;s;s;s;s;s;s;s;s;s;s;s;s;0;0;0;0;0;0;0;0;0;0;0;0;0;0;0;0;0;0;0;0;0;0;0;0;0;0;0;0;0;0;0;0;0;0;0;0;0;0;0;0;0;0;0;0;0;0;0;0;0;0;0;0;0;0;0;0;0;s;s;s;s
s;s;s;s;s;s;s;s;s;s;#;0;0;0;0;0;0;0;0;0;0;0;0;0;0;0;0;0;0;0;0;0;0;0;0;0;0;0;0;0;0;0;0;0;0;0;0;0;0;0;0;0;0;0;0;0;0;0;0;0;0;0;0;0;0;0;0;0;0;0;0;0;0;0;0;0;s;s;s;s
s;s;s;s;s;s;s;s;s;#;#;0;0;0;0;0;0;0;0;0;0;0;0;0;0;0;0;0;0;0;0;0;0;0;0;0;0;0;0;0;0;0;0;0;0;0;0;0;0;0;0;0;0;0;0;0;0;0;0;0;0;0;0;0;0;0;0;0;0;0;0;0;0;s;s;s;s;s;s;s
s;s;s;s;s;s;s;s;s;#;#;0;0;0;0;0;0;0;0;0;0;0;0;0;0;0;0;0;0;0;0;s;s;s;s;s;#;#;0;0;0;0;0;0;0;0;0;0;0;s;s;0;0;0;0;0;0;0;0;0;0;0;0;0;0;0;0;0;0;0;0;0;0;0;s;s;s;s;s;s
s;s;s;s;s;s;s;s;s;s;s;0;0;0;0;0;0;0;0;0;0;0;0;0;0;0;0;0;0;s;s;s;s;s;s;#;#;#;0;0;0;0;0;0;0;0;0;0;0;s;s;0;0;0;0;0;0;0;0;0;0;0;0;0;0;0;0;0;0;0;0;0;0;0;s;s;s;s;s;s
s;s;s;s;s;s;s;s;s;s;s;0;0;0;0;0;0;0;0;0;0;0;0;0;0;0;0;0;s;s;s;s;s;s;s;#;#;s;s;s;s;s;s;s;s;s;s;s;s;s;s;0;0;0;0;0;0;0;0;0;0;0;0;0;0;0;0;0;0;0;0;0;0;s;s;s;s;s;s;n
s;s;s;s;s;s;s;s;s;s;s;0;0;0;0;0;0;0;0;0;0;0;0;0;0;0;0;s;s;s;s;s;s;s;s;s;s;s;s;s;s;s;s;s;s;s;s;s;s;s;s;s;s;s;s;s;s;s;0;0;0;0;0;0;0;0;0;0;0;0;0;0;0;s;s;s;s;s;s;n
s;s;s;s;s;s;s;s;s;s;s;0;0;0;0;0;0;0;0;0;0;0;0;0;0;0;0;s;s;s;s;s;s;s;s;s;s;s;s;s;s;s;s;s;s;s;s;s;s;s;s;s;s;s;s;s;s;s;0;0;0;0;0;0;0;0;0;0;0;0;0;0;0;#;s;s;s;n;n;n
s;s;s;s;s;s;s;s;s;s;s;s;s;0;0;s;s;s;s;0;0;0;0;0;0;0;0;s;s;s;s;s;s;s;s;s;s;s;s;s;s;s;s;s;s;s;s;s;s;s;s;s;s;s;s;s;s;s;0;0;0;0;0;0;0;0;0;0;0;0;0;0;0;#;#;s;s;n;n;n
s;s;s;s;s;s;s;s;s;s;s;s;s;0;0;s;s;s;s;0;0;0;0;0;0;0;0;s;s;s;s;s;s;s;s;s;s;s;s;s;s;s;s;s;s;s;s;s;s;s;s;s;s;s;s;s;s;s;0;0;0;0;0;s;0;0;0;0;0;0;0;0;0;#;#;s;s;s;s;n
s;s;s;s;s;s;s;s;s;s;s;0;0;0;0;0;0;s;s;0;0;0;0;0;0;0;0;s;s;s;s;s;s;s;s;s;s;s;s;s;s;s;s;s;s;s;s;s;s;s;s;s;s;s;s;s;s;s;0;0;0;0;0;s;0;0;0;0;0;0;0;0;0;#;s;s;s;n;s;n
s;s;s;s;s;s;s;s;s;s;s;0;0;0;0;0;0;s;s;0;0;0;0;0;0;0;0;0;0;0;s;s;s;s;s;s;s;s;s;s;s;s;s;s;s;s;s;s;s;s;s;s;s;s;s;s;s;s;0;0;0;0;0;0;0;0;0;0;0;0;0;0;0;s;s;s;s;s;s;n
s;s;s;s;s;s;s;s;s;s;s;0;0;0;0;0;0;s;s;0;0;0;0;0;0;0;0;0;0;0;s;s;s;s;s;s;s;s;s;s;s;s;s;s;s;s;s;s;s;s;s;s;s;s;s;s;s;s;0;0;0;0;0;0;0;0;0;0;0;0;0;0;0;s;s;s;s;s;n;n
s;s;s;s;s;s;s;s;s;s;s;0;0;0;0;0;0;s;s;0;0;0;0;0;0;0;0;s;s;s;s;s;s;s;s;s;s;s;s;s;s;s;s;s;s;s;s;s;s;s;s;s;s;s;s;s;s;#;0;0;0;0;0;0;0;0;0;0;0;0;0;0;0;0;s;s;s;s;n;n
s;s;s;s;s;s;s;s;s;s;s;0;0;0;0;0;0;s;s;0;0;0;0;0;0;0;0;s;s;s;s;s;s;s;s;s;s;s;s;s;s;s;s;s;s;s;s;s;s;s;s;s;s;s;s;s;#;#;0;0;0;0;0;0;0;0;0;0;0;0;0;0;0;0;s;n;n;s;s;n
s;s;s;s;s;s;s;s;s;s;s;0;0;0;0;0;0;s;s;0;0;0;0;0;0;0;0;#;#;#;s;s;s;s;s;s;s;s;s;s;s;s;s;s;s;s;s;s;s;s;s;s;s;s;s;s;#;#;0;0;0;0;0;0;0;0;0;0;0;0;0;0;0;s;s;n;s;s;s;n
s;s;s;s;s;s;s;s;s;s;s;0;0;0;0;0;0;s;s;0;0;0;0;0;0;0;0;#;#;#;s;s;s;s;0;0;s;s;s;s;s;s;s;s;s;s;#;#;s;s;s;s;s;0;0;0;0;0;0;0;0;0;0;0;0;0;0;0;0;0;0;0;0;s;s;s;s;n;n;n
s;s;s;s;s;s;s;s;s;s;s;0;0;0;0;0;0;s;s;0;0;0;0;0;0;0;0;#;#;#;#;s;s;s;0;0;s;s;s;s;s;s;s;s;s;#;#;#;#;#;s;s;s;0;0;0;0;0;0;0;0;0;0;0;0;0;0;0;0;0;0;0;0;s;s;s;s;n;n;n
s;0;0;0;0;0;0;0;0;0;0;0;0;0;0;0;0;0;0;0;0;0;0;0;0;0;0;0;0;0;0;0;0;0;0;0;0;0;0;0;0;0;0;0;0;0;0;0;0;0;0;0;0;0;0;0;0;0;0;0;0;0;0;0;0;0;0;0;0;0;0;0;0;0;0;0;0;0;0;0
s;0;0;0;0;0;0;0;0;0;0;0;0;0;0;0;0;0;0;0;0;0;0;0;0;0;0;0;0;0;0;0;0;0;0;0;0;0;0;0;0;0;0;0;0;0;0;0;0;0;0;0;0;0;0;0;0;0;0;0;0;0;0;0;0;0;0;0;0;0;0;0;0;0;0;0;0;0;0;0
s;0;0;0;0;0;0;0;0;0;0;0;0;0;0;0;0;0;0;0;0;0;0;0;0;0;0;0;0;0;0;0;0;0;0;0;0;0;0;0;0;0;0;0;0;0;0;0;0;0;0;0;0;0;0;0;0;0;0;0;0;0;0;0;0;0;0;0;0;0;0;0;0;0;0;0;0;0;0;0
s;0;0;0;0;0;0;0;0;0;0;0;0;0;0;0;0;0;0;0;0;0;0;0;0;0;0;0;0;0;0;0;0;0;0;0;0;0;0;0;0;0;0;0;0;0;0;0;0;0;0;0;0;0;0;0;0;0;0;0;0;0;0;0;0;0;0;0;0;0;0;0;0;0;0;0;0;0;0;0
s;0;0;0;0;0;0;0;0;0;0;0;0;0;0;0;0;0;0;0;0;0;0;0;0;0;0;0;0;0;0;0;0;0;0;0;0;0;0;0;0;0;0;0;0;0;0;0;0;0;0;0;0;0;0;0;0;0;0;0;0;0;0;0;0;0;0;0;0;0;0;0;0;0;0;0;0;0;0;0
s;0;0;0;0;0;0;0;0;0;0;0;0;0;0;0;0;0;0;0;0;0;0;0;0;0;0;0;0;0;0;0;0;0;0;0;0;0;0;0;0;0;0;0;0;0;0;0;0;0;0;0;0;0;0;0;0;0;0;0;0;0;0;0;0;0;0;0;0;0;0;0;0;0;0;0;0;0;0;0
s;s;s;0;0;0;0;s;#;#;#;0;0;0;0;0;0;0;0;0;0;0;0;0;0;0;0;0;0;0;0;0;0;0;0;0;0;0;0;0;0;0;0;0;0;0;0;0;0;0;0;0;0;0;0;0;0;0;0;0;0;0;0;0;0;0;0;0;0;0;0;0;0;s;s;s;s;n;n;n
s;s;s;0;0;0;0;s;#;#;#;0;0;0;0;0;0;0;0;0;0;0;0;0;0;0;0;0;0;0;0;0;0;0;0;0;0;0;0;0;0;0;0;0;0;0;0;0;0;0;0;0;0;0;0;0;0;0;0;0;0;0;0;0;0;0;0;0;0;0;0;0;0;s;s;s;s;n;n;n
s;s;s;0;0;0;0;s;#;#;s;0;0;0;0;0;0;0;0;0;0;0;0;0;0;0;0;0;0;0;0;0;0;0;0;0;0;0;0;0;0;0;0;0;0;0;0;0;0;0;0;0;0;0;0;0;0;0;0;0;0;0;0;0;0;0;0;0;0;0;0;0;0;s;s;s;s;s;n;n
s;s;s;0;0;0;0;s;s;s;s;0;0;0;0;0;0;0;0;0;0;0;0;0;0;0;0;0;0;0;0;0;0;0;0;0;0;0;0;0;0;0;0;0;0;0;0;0;0;0;0;0;0;0;0;0;0;0;0;0;0;0;0;0;0;0;0;0;0;0;0;0;0;s;s;n;n;s;n;n
s;s;s;0;0;0;0;s;s;s;s;0;0;0;0;0;0;0;0;0;0;0;0;0;0;0;0;0;0;0;0;0;0;0;0;0;0;0;0;0;0;0;0;0;0;0;0;0;0;0;0;0;0;0;0;0;0;0;0;0;0;0;0;0;0;0;0;0;0;0;0;0;0;s;s;n;n;s;n;n
s;s;s;0;0;0;0;s;N;s;s;0;0;0;0;0;0;0;0;0;0;0;0;0;0;0;0;0;0;0;0;0;0;0;0;0;0;0;0;0;0;0;0;0;0;0;0;0;0;0;0;0;0;0;0;0;0;0;0;0;0;0;0;0;0;0;0;0;0;0;0;0;0;s;s;s;s;s;n;n
s;s;s;0;0;0;0;s;N;s;s;0;0;0;0;0;0;0;0;0;0;0;0;0;0;0;s;s;0;0;0;0;0;0;0;0;0;0;0;0;0;0;0;0;0;0;0;0;0;0;0;0;0;0;0;0;0;0;0;0;0;0;0;0;0;0;0;0;0;0;0;0;0;#;s;s;s;n;n;n
N;s;s;0;0;0;0;s;N;N;s;0;0;0;0;0;0;0;0;0;0;0;0;0;0;0;s;s;0;0;0;0;0;0;0;0;0;0;0;0;0;0;0;0;0;0;0;0;0;0;0;0;0;0;0;0;0;0;0;0;0;0;0;0;0;0;0;0;0;0;0;0;0;#;#;#;s;n;n;n
N;s;N;0;0;0;0;s;N;N;N;0;0;0;0;0;0;0;0;0;0;0;0;0;0;0;s;s;0;0;0;0;0;0;0;0;0;0;0;0;0;0;0;0;0;0;0;0;0;0;0;0;0;0;0;0;0;0;0;0;0;0;0;0;0;0;0;0;0;0;0;0;0;#;#;s;s;s;s;n
N;N;N;0;0;0;0;N;0;N;N;s;s;s;s;s;s;s;s;s;s;s;s;s;s;s;s;s;s;s;s;s;s;s;s;s;s;s;s;#;#;#;s;s;s;s;s;s;s;s;s;s;s;s;s;s;s;s;s;s;s;s;s;s;s;s;s;s;s;s;s;s;s;s;s;s;s;s;n;n
N;N;N;0;0;0;0;N;N;N;N;N;N;N;s;N;s;s;s;s;s;s;s;s;s;s;s;s;s;s;s;s;s;s;s;s;s;s;s;#;#;s;s;s;s;s;s;s;s;s;s;s;s;s;s;s;s;s;s;s;s;s;s;s;s;s;s;s;s;s;s;s;s;s;n;n;s;s;n;n
