0;0;0;0;0;0;0;0;0;0;0;0;0;0;0;0;0;0;0;0;0;0;0;B;B;B;B;B;B;B;B;0;0;0;0;0;B;B;B;0;0;0;0;0;0;0;0;0;0;0
0;0;0;0;0;0;0;0;0;0;0;0;0;0;0;0;0;0;0;0;0;0;0;B;B;B;B;B;B;B;B;0;0;0;0;0;B;B;B;0;0;0;0;0;0;0;0;0;0;0
0;0;0;0;0;0;0;0;0;0;0;0;0;0;0;0;0;0;0;0;0;0;0;B;B;B;B;B;B;B;B;0;0;0;0;0;B;B;B;0;0;0;0;0;0;0;0;0;0;0
0;0;0;0;0;0;0;0;0;0;0;0;0;0;0;0;0;0;0;0;0;0;0;B;B;B;B;B;B;B;B;B;B;B;B;B;B;B;B;0;0;0;0;0;0;0;0;0;0;0
0;0;0;0;0;0;0;0;0;0;0;0;0;0;0;0;0;0;0;0;0;0;0;B;B;B;B;B;B;B;B;B;B;B;B;B;B;B;0;0;0;0;0;0;0;0;0;0;0;0
0;0;0;0;0;0;0;0;0;0;0;0;0;0;0;0;0;0;0;0;0;0;0;B;B;B;B;B;B;B;B;B;B;B;B;B;B;0;0;0;0;0;0;0;0;0;0;0;0;0
0;0;0;0;0;0;0;0;0;0;0;0;0;0;0;0;0;0;0;0;0;0;0;B;B;B;B;B;B;B;B;B;B;B;B;B;0;0;0;0;0;0;0;0;0;0;0;0;0;0
0;0;0;0;0;0;0;0;0;0;0;0;0;0;0;0;0;0;0;0;0;0;0;B;B;B;B;B;B;B;B;B;B;B;B;B;0;0;0;0;0;0;0;0;0;0;0;0;0;0
0;0;0;0;0;0;0;0;0;0;0;0;0;0;0;0;0;0;0;0;0;0;0;0;0;0;0;0;0;0;0;0;B;B;B;B;B;B;0;0;0;0;0;0;0;0;0;0;0;0
0;0;0;0;0;0;0;0;0;0;0;0;0;0;0;0;0;0;0;0;0;0;0;0;0;0;0;0;0;0;0;0;0;0;0;B;B;B;0;0;0;0;0;0;0;0;0;0;0;0
0;0;0;0;0;0;0;0;0;0;0;0;0;0;0;0;0;0;0;0;0;0;0;0;0;0;0;0;0;0;0;0;0;0;0;B;B;B;0;0;0;0;0;0;0;0;0;0;0;0
0;0;0;0;0;0;0;0;0;0;0;0;0;0;0;0;0;0;0;0;0;0;0;0;0;0;0;0;0;0;0;0;0;0;0;B;B;B;0;0;0;0;0;0;0;0;0;0;0;0
0;0;0;0;0;0;0;0;B;B;0;0;0;0;0;0;0;0;0;0;0;0;0;0;0;0;0;0;0;0;0;0;0;0;0;B;B;0;0;0;0;0;0;0;0;0;0;0;0;0
0;0;0;0;0;0;0;0;B;B;0;0;0;0;0;0;0;0;0;0;0;0;0;0;0;0;0;0;0;0;0;0;0;0;0;B;B;0;0;0;0;0;0;0;0;0;0;0;0;0
0;0;0;0;0;0;0;0;B;B;0;0;0;0;0;0;0;0;0;0;0;0;0;0;0;0;0;0;0;0;0;0;0;0;0;0;0;0;0;0;0;0;0;0;0;0;0;0;0;0
0;0;0;0;0;0;0;0;B;B;0;0;0;0;0;0;0;0;0;0;0;0;0;0;0;0;0;0;0;0;0;0;0;0;0;0;0;0;0;0;0;0;0;0;0;0;0;0;0;0
0;0;0;0;0;0;0;B;B;B;0;0;0;0;0;0;0;0;0;0;0;0;0;0;0;0;0;0;0;0;0;0;0;0;0;0;0;0;B;B;0;0;0;0;0;0;0;0;0;0
0;0;0;0;0;0;0;B;B;B;0;0;0;0;0;0;0;0;0;0;0;0;0;0;B;B;B;B;B;B;B;B;0;0;0;0;0;B;B;B;0;0;0;0;0;0;0;0;0;0
0;0;0;0;0;0;0;B;B;B;0;0;0;0;0;0;0;0;0;0;0;0;0;B;B;B;B;B;B;B;B;B;B;B;B;B;B;B;B;0;0;0;0;0;0;0;0;0;0;0
0;0;0;0;0;0;0;B;B;B;0;0;0;0;0;0;0;0;0;0;0;0;0;B;B;B;B;B;B;B;B;B;B;B;B;B;B;B;B;0;0;0;0;0;0;0;0;0;0;0
0;0;0;0;0;0;0;B;B;B;0;0;0;0;0;0;0;0;0;0;0;0;0;B;B;B;B;B;B;B;B;B;B;B;B;B;B;B;B;0;0;0;0;0;0;0;0;0;0;0
0;0;0;0;0;0;0;B;B;B;0;0;0;0;0;B;B;B;B;B;B;B;B;B;B;B;B;B;B;B;B;B;B;B;B;B;B;B;B;0;0;0;0;0;0;0;0;0;0;0
0;0;0;0;0;0;B;B;B;0;0;0;0;B;B;B;B;B;B;B;B;B;B;B;B;B;B;B;B;B;B;B;B;B;B;B;B;B;B;0;0;0;0;0;0;0;0;0;0;0
0;0;0;0;0;0;B;B;B;0;0;0;B;B;B;B;B;B;B;B;B;B;B;B;B;B;B;B;B;B;B;B;B;B;B;B;B;B;B;0;0;0;0;0;0;0;0;0;0;0
0;0;0;0;0;0;B;B;B;0;0;0;B;B;B;0;0;0;0;B;B;B;B;B;B;B;B;B;B;B;B;B;B;0;0;0;0;B;B;0;0;0;0;0;0;0;0;0;0;0
0;0;0;0;0;0;B;B;B;0;0;0;B;B;B;0;0;0;0;B;B;B;B;B;B;B;B;B;B;B;B;B;B;0;0;0;0;B;B;0;0;0;0;0;0;0;0;0;0;0
0;0;0;0;0;0;B;B;B;0;0;0;B;B;B;B;B;0;0;0;0;B;B;B;B;B;B;B;B;B;B;B;B;0;0;0;0;0;0;0;0;0;0;0;0;0;0;0;0;0
0;0;0;0;0;0;B;B;B;0;0;0;B;B;B;B;B;B;B;B;B;B;B;0;B;B;B;B;B;B;B;B;B;0;0;0;0;0;0;0;0;0;0;0;0;0;0;0;0;0
0;0;0;0;0;0;B;B;B;0;0;0;B;B;B;B;B;B;B;B;B;B;B;B;B;B;B;B;B;B;B;B;B;B;B;0;0;0;0;0;0;0;0;0;0;0;0;0;0;0
0;0;0;0;0;0;B;B;B;0;0;0;B;B;B;B;B;B;B;B;B;B;B;B;B;B;B;B;B;B;B;B;B;B;B;B;B;B;B;B;B;0;0;0;0;0;0;0;0;0
0;0;0;0;0;0;B;B;B;0;0;0;B;B;B;B;B;B;B;B;B;B;0;0;0;B;B;B;B;B;B;B;B;B;B;B;B;B;B;B;B;B;0;0;0;0;0;0;0;0
0;0;0;0;0;0;B;B;B;0;0;0;B;B;B;B;B;B;B;B;B;B;B;B;B;B;B;B;B;B;B;B;B;B;B;B;B;B;B;B;B;B;0;0;0;0;0;0;0;0
0;0;0;0;0;0;B;B;B;B;B;0;0;0;B;B;B;B;B;B;B;B;B;B;B;B;B;B;B;B;B;B;B;B;B;B;B;B;B;B;B;0;0;0;0;0;0;0;0;0
0;0;0;0;0;0;0;0;B;B;B;0;0;0;0;0;0;0;0;0;B;B;B;B;B;B;B;B;B;B;B;B;B;B;B;0;0;0;0;0;0;0;0;0;0;0;0;0;0;0
0;0;0;0;0;0;0;0;B;B;B;0;0;0;0;0;0;0;0;0;0;0;0;B;B;B;B;B;B;B;B;B;B;B;B;B;0;0;0;0;0;0;0;0;0;0;0;0;0;0
0;0;0;0;0;0;0;0;0;0;0;0;0;0;0;0;0;0;0;0;0;0;B;B;B;B;B;B;B;B;B;B;B;B;B;B;B;B;0;0;0;0;0;0;0;0;0;0;0;0
0;0;0;0;0;0;0;0;0;0;0;0;0;0;0;0;0;0;0;0;0;0;B;B;B;B;B;B;B;B;B;B;B;B;B;B;B;B;0;0;0;0;0;0;0;0;0;0;0;0
0;0;0;0;0;0;0;0;0;0;0;0;0;0;0;0;0;0;0;0;0;0;B;B;B;B;B;B;B;B;B;B;B;B;B;B;B;B;0;0;0;0;0;0;0;0;0;0;0;0
0;0;0;0;0;0;0;0;0;0;0;0;0;0;0;0;0;0;0;0;0;0;B;B;B;B;B;B;B;B;B;B;B;B;B;B;B;B;B;B;0;0;0;0;0;0;0;0;0;0
0;0;0;0;0;0;0;0;0;0;0;0;0;B;B;B;B;B;B;B;0;0;B;B;B;B;B;B;B;B;B;B;B;B;B;B;0;0;0;0;0;0;0;0;0;0;0;0;0;0
0;0;0;0;0;0;0;0;0;0;0;0;0;B;B;B;B;B;B;B;B;B;B;B;B;B;B;B;0;0;0;0;0;0;0;0;0;0;0;0;0;0;0;0;0;0;0;0;0;0
0;0;0;0;0;0;0;0;0;0;0;0;0;B;B;B;B;B;B;B;B;B;B;B;B;B;B;B;0;0;0;0;0;0;0;0;0;0;0;0;0;0;0;0;0;0;0;0;0;0
0;0;0;0;0;0;0;0;0;0;0;0;0;B;B;B;B;B;B;B;B;B;B;B;B;B;B;B;0;0;0;0;0;0;0;0;0;B;B;0;0;0;0;0;0;0;0;0;0;0
0;0;0;0;0;0;0;0;0;0;0;0;0;B;B;B;B;B;B;B;B;B;B;B;B;B;B;B;0;0;0;0;0;0;0;0;0;B;B;0;0;0;0;0;0;0;0;0;0;0
0;0;0;0;0;0;0;0;0;0;0;0;0;B;B;B;B;B;B;B;B;B;B;B;B;B;B;B;0;0;0;0;0;0;0;0;0;B;B;0;0;0;0;0;0;0;0;0;0;0
0;0;0;0;0;0;0;0;0;0;0;0;0;B;B;B;B;B;B;B;B;B;B;B;B;B;B;B;0;0;0;0;0;0;0;0;0;B;B;B;0;0;0;0;0;0;0;0;0;0
0;0;0;0;0;0;0;0;0;0;0;0;0;B;B;B;B;B;B;B;0;0;0;0;0;0;0;0;0;0;0;0;0;0;0;0;0;B;B;B;0;0;0;0;0;0;0;0;0;0
0;0;0;0;0;0;0;0;0;0;0;0;0;0;0;0;0;B;B;B;0;0;0;0;0;0;0;0;0;0;0;0;0;0;0;0;0;B;B;B;0;0;0;0;0;0;0;0;0;0
0;0;0;0;0;0;0;0;0;0;0;0;0;0;0;0;0;0;0;0;0;0;0;0;0;0;0;0;0;0;0;0;0;0;0;0;0;B;B;B;0;0;0;0;0;0;0;0;0;0
0;0;0;0;0;0;0;0;0;0;0;0;0;0;0;0;0;0;0;0;0;0;0;0;0;0;0;0;0;0;0;0;0;0;0;0;0;0;B;B;B;0;0;0;0;0;0;0;0;0
0;0;0;0;0;0;0;0;0;0;0;0;0;0;0;0;0;0;0;0;0;0;0;0;0;0;0;0;0;0;0;0;0;0;0;0;0;0;B;B;B;0;0;0;0;0;0;0;0;0
0;0;0;0;0;0;0;0;0;0;0;0;0;0;0;0;0;0;0;0;0;0;0;0;0;0;0;0;0;0;0;0;0;0;0;0;0;0;B;B;B;0;0;0;0;0;0;0;0;0
0;0;0;0;0;0;0;0;0;0;0;0;0;0;0;0;0;0;0;0;0;0;0;0;0;0;0;0;0;0;0;0;0;0;0;0;0;0;B;B;0;0;0;0;0;0;0;0;0;0
0;0;0;0;0;0;0;0;0;0;0;0;0;0;0;0;0;0;0;0;0;0;0;0;0;0;0;0;0;0;0;0;0;0;0;0;0;0;0;0;0;0;0;0;0;0;0;0;0;0
0;0;0;0;0;0;0;0;0;0;0;0;B;B;B;B;0;0;0;0;0;0;0;0;0;0;0;0;0;0;0;0;0;0;0;0;B;B;B;B;0;0;0;0;0;0;0;0;0;0
0;0;0;0;0;0;0;0;0;0;0;0;B;B;B;B;0;0;0;0;0;0;0;0;0;0;0;0;0;0;0;0;0;0;0;0;B;B;B;B;0;0;0;0;0;0;0;0;0;0
0;0;0;0;0;0;0;0;0;0;0;0;B;B;B;B;0;0;0;0;0;0;0;0;0;0;0;0;0;0;0;0;0;0;0;0;0;0;B;B;B;0;0;0;0;0;0;0;0;0
0;0;0;0;0;0;0;0;0;0;0;0;0;B;B;B;0;0;0;0;0;0;0;0;0;0;0;0;0;0;0;0;0;0;0;0;0;B;B;B;B;0;0;0;0;0;0;0;0;0
0;0;0;0;0;0;0;0;0;0;0;0;0;B;B;B;0;0;0;0;0;0;0;0;0;0;0;0;0;0;0;0;0;0;0;0;0;B;B;B;B;0;0;0;0;0;0;0;0;0
0;0;0;0;0;0;0;0;0;0;0;0;0;0;B;B;0;0;0;0;0;0;0;0;0;0;0;0;0;0;0;0;0;0;0;0;0;B;B;B;0;0;0;0;0;0;0;0;0;0
0;0;0;0;0;0;0;0;0;0;0;0;0;0;0;0;0;0;0;B;B;B;B;B;B;B;B;B;B;0;0;0;0;0;0;0;0;B;B;B;0;0;0;0;0;0;0;0;0;0
0;0;0;0;0;0;0;0;0;0;0;0;0;0;0;0;0;0;0;B;B;B;B;B;B;B;B;B;B;0;0;0;0;0;0;0;0;B;B;B;0;0;0;0;0;0;0;0;0;0
0;0;0;0;0;0;0;0;0;0;0;0;0;0;B;B;0;0;0;B;B;B;B;B;B;B;B;B;B;0;0;0;0;0;0;B;B;B;B;B;0;0;0;0;0;0;0;0;0;0
0;0;0;0;0;0;0;0;0;0;0;0;0;0;B;B;0;0;0;B;B;B;B;B;B;B;B;B;B;0;0;0;0;0;0;B;B;B;B;B;0;0;0;0;0;0;0;0;0;0
0;0;0;0;0;0;0;0;0;0;0;0;0;0;B;B;0;0;0;B;B;B;B;B;B;B;B;B;B;B;B;0;0;0;0;B;B;B;0;0;0;0;0;0;0;0;0;0;0;0
0;0;0;0;0;0;0;0;0;0;0;0;0;B;B;B;B;B;0;0;0;0;0;0;0;B;B;B;B;B;B;0;0;0;0;0;0;0;0;0;0;0;0;0;0;0;0;0;0;0
0;0;0;0;0;0;0;0;0;0;0;0;0;B;B;B;B;B;0;0;0;0;0;0;0;B;B;B;B;B;B;B;B;B;B;B;0;0;0;0;0;0;0;0;0;0;0;0;0;0
0;0;0;0;0;0;0;0;0;0;0;0;0;B;B;B;B;B;0;0;0;0;0;0;0;B;B;B;B;B;B;B;B;B;B;B;0;0;0;0;0;0;0;0;0;0;0;0;0;0
0;0;0;0;0;0;0;0;0;0;0;0;0;B;B;B;B;B;0;0;0;0;0;0;0;B;B;B;B;B;B;B;B;B;B;B;0;0;0;0;0;0;0;0;0;0;0;0;0;0
0;0;0;0;0;0;0;0;0;0;0;0;0;B;B;B;B;B;0;0;0;0;0;0;0;B;B;B;B;B;B;B;B;B;B;B;0;0;0;0;0;0;0;0;0;0;0;0;0;0
0;0;0;0;0;0;0;0;0;0;0;0;0;B;B;B;B;B;0;B;B;B;B;B;B;B;B;B;B;B;0;0;B;B;B;B;0;0;0;0;0;0;0;0;0;0;0;0;0;0
0;0;0;0;0;0;0;0;0;0;0;0;0;0;0;B;B;B;0;B;B;B;B;B;B;B;B;B;B;B;0;0;B;B;B;B;0;0;0;0;0;0;0;0;0;0;0;0;0;0
0;0;0;0;0;0;0;0;0;0;0;0;0;0;0;0;0;B;B;B;B;B;B;B;B;B;B;B;B;0;0;0;0;0;0;0;0;0;0;0;0;0;0;0;0;0;0;0;0;0
0;0;0;0;0;0;0;0;0;0;0;0;0;0;0;0;0;0;0;0;B;B;B;B;B;B;B;B;B;0;0;0;0;0;0;0;0;0;0;0;0;0;0;0;0;0;0;0;0;0
0;0;0;0;0;0;0;0;0;0;0;0;0;0;0;0;0;B;B;B;B;B;B;B;B;B;B;B;B;0;0;0;0;0;0;0;0;0;0;0;0;0;0;0;0;0;0;0;0;0
0;0;0;0;0;0;0;0;0;0;0;0;0;0;0;0;B;B;B;B;B;B;B;B;B;0;0;0;0;0;0;0;0;0;0;0;0;0;0;0;0;0;0;0;0;0;0;0;0;0
0;0;0;0;0;0;0;0;0;0;0;0;0;0;0;0;B;B;B;B;B;B;B;B;B;0;0;0;0;0;0;0;0;0;0;0;0;0;0;0;0;0;0;0;0;0;0;0;0;0
0;0;0;0;0;0;0;0;0;0;0;0;0;0;3;3;B;B;B;B;0;0;0;0;0;0;0;0;0;0;0;0;0;0;0;0;0;0;0;0;0;0;0;0;0;0;0;0;0;0
0;0;0;0;0;0;0;0;0;0;0;0;0;0;3;3;B;B;B;B;B;B;B;B;B;B;B;B;B;B;B;0;0;0;0;0;0;0;0;0;0;0;0;0;0;0;0;0;0;0
0;0;0;0;0;0;0;0;0;0;0;0;0;0;3;3;B;B;B;B;B;B;B;B;B;B;B;B;B;B;B;0;0;0;0;0;0;0;0;0;0;0;0;0;0;0;0;0;0;0
0;0;0;0;0;0;0;0;0;0;0;0;0;0;3;3;B;B;B;B;B;B;B;B;B;B;B;B;B;B;B;0;0;0;3;3;3;3;0;0;0;0;0;0;0;0;0;0;0;0
0;0;0;0;0;0;0;0;0;0;0;0;0;3;3;3;B;B;B;B;B;B;B;B;B;B;B;B;B;B;B;0;0;0;3;3;3;3;0;0;0;0;0;0;0;0;0;0;0;0
0;0;0;0;0;0;0;0;0;0;0;0;0;3;3;3;B;B;B;B;B;B;B;B;B;B;B;B;B;B;B;B;0;0;3;3;3;3;3;0;0;0;0;0;0;0;0;0;0;0
0;0;0;0;0;0;0;0;0;0;0;3;0;0;0;0;0;0;0;0;0;0;0;0;0;0;0;B;B;B;B;B;0;0;3;3;3;3;3;0;0;0;0;0;0;0;0;0;0;0
0;0;0;0;0;0;0;0;0;0;0;3;0;0;0;0;0;0;0;0;0;0;0;0;0;0;0;B;B;B;B;B;0;0;3;3;3;3;3;0;0;0;0;0;0;0;0;0;0;0
0;0;0;0;0;0;0;0;0;0;3;3;3;3;0;0;0;0;0;0;0;0;0;0;0;0;0;B;B;B;B;B;0;0;3;3;3;3;3;0;0;0;0;0;0;0;0;0;0;0
0;0;0;0;0;0;0;0;0;0;3;3;3;3;0;0;0;0;0;0;0;0;0;0;0;0;0;B;B;B;B;B;0;0;3;3;3;3;0;0;0;0;0;0;0;0;0;0;0;0
0;0;0;0;0;0;0;0;0;0;3;3;3;3;0;0;B;B;B;B;B;B;B;B;B;B;B;B;B;B;B;B;0;0;3;3;3;3;0;0;0;0;0;0;0;0;0;0;0;0
0;0;0;0;0;0;0;0;0;0;3;3;3;3;0;0;B;B;B;B;B;B;B;B;B;B;B;B;B;B;B;B;0;0;3;3;3;3;0;0;0;0;0;0;0;0;0;0;0;0
0;0;0;0;0;0;0;0;0;0;3;0;0;0;0;0;B;B;B;B;B;B;B;B;B;B;B;B;B;B;B;B;0;0;0;0;0;0;0;0;0;0;0;0;0;0;0;0;0;0
0;0;0;0;0;0;0;0;0;0;0;0;0;0;0;0;B;B;B;B;B;B;B;B;B;B;B;B;B;B;B;B;0;0;0;0;0;0;0;0;0;0;0;0;0;0;0;0;0;0
0;0;0;0;0;0;0;0;0;0;0;0;0;0;0;0;B;B;B;B;B;B;B;B;B;B;B;B;B;B;B;B;0;0;0;0;0;0;0;0;0;0;0;0;0;0;0;0;0;0
0;0;0;0;0;0;0;0;0;0;0;0;0;0;0;0;B;B;B;B;B;B;B;B;B;B;B;B;B;B;B;B;0;0;0;0;0;0;0;0;0;0;0;0;0;0;0;0;0;0
0;0;0;0;0;0;0;0;0;0;0;0;0;0;0;0;B;B;B;B;B;B;B;B;B;B;B;B;B;B;0;0;0;0;0;0;0;0;0;0;0;0;0;0;0;0;0;0;0;0
0;0;0;0;0;0;0;0;0;0;0;0;0;0;0;0;B;B;B;B;B;B;B;B;B;B;B;B;B;B;B;B;B;B;B;B;0;0;0;0;0;0;0;0;0;0;0;0;0;0
0;0;0;0;0;0;0;0;0;0;0;0;0;0;0;0;B;B;B;B;B;B;B;B;B;B;B;B;B;B;B;B;B;B;B;B;0;0;0;0;0;0;0;0;0;0;0;0;0;0
0;0;0;0;0;0;0;0;0;0;0;0;0;0;0;0;B;B;B;B;B;B;B;B;B;B;B;B;B;B;B;B;B;B;B;B;B;0;0;0;0;0;0;0;0;0;0;0;0;0
0;0;0;0;0;0;0;0;0;0;0;0;0;0;0;0;B;B;B;B;B;B;B;B;B;B;B;B;B;B;B;B;B;B;B;B;B;B;B;B;0;0;0;0;0;0;0;0;0;0
0;0;0;0;0;0;0;0;0;0;0;0;0;0;0;0;B;B;B;B;B;B;B;B;B;B;B;B;B;B;B;B;B;B;B;B;0;B;B;B;0;0;0;0;0;0;0;0;0;0
0;0;0;0;0;0;0;0;0;0;0;0;0;0;0;0;0;0;0;0;0;0;0;0;0;0;0;0;0;0;0;0;0;0;0;0;0;B;B;B;0;0;0;0;0;0;0;0;0;0
