Y;Y;Y;Y;Y;Y;Y;Y;Y;Y;Y;Y;Y;Y;Y;Y;Y;Y;Y;Y;Y;Y;Y;Y;Y;Y;Y;Y;Y;Y;Y;Y;Y;Y;Y;Y;Y;Y;Y;Y;Y;Y;Y;Y;Y;Y
Y;Y;Y;Y;Y;Y;Y;Y;Y;Y;Y;Y;Y;Y;Y;Y;Y;Y;Y;Y;Y;Y;Y;Y;Y;Y;Y;Y;Y;Y;Y;Y;Y;Y;Y;Y;Y;Y;Y;Y;Y;Y;Y;Y;Y;Y
Y;Y;Y;Y;Y;Y;Y;Y;Y;Y;Y;Y;Y;Y;Y;Y;Y;Y;Y;Y;Y;Y;Y;Y;Y;Y;Y;Y;Y;Y;Y;Y;Y;Y;Y;Y;Y;Y;Y;Y;Y;Y;Y;Y;Y;Y
Y;Y;Y;Y;Y;Y;Y;Y;Y;0;0;0;Y;Y;Y;Y;Y;Y;Y;Y;Y;Y;Y;Y;Y;Y;0;0;0;Y;Y;Y;Y;Y;Y;Y;Y;Y;Y;Y;Y;Y;Y;Y;Y;Y
Y;0;0;0;0;0;0;0;0;0;0;0;Y;Y;Y;Y;Y;Y;Y;Y;Y;Y;Y;Y;Y;Y;0;0;0;0;0;0;0;0;0;0;0;0;0;0;0;0;0;Y;Y;Y
Y;0;0;0;0;0;0;0;0;0;0;0;0;Y;Y;Y;Y;Y;Y;Y;Y;Y;Y;Y;Y;0;0;0;0;0;0;0;0;0;0;0;0;0;0;0;0;0;0;Y;Y;Y
Y;0;0;0;0;0;0;0;0;0;0;0;0;Y;Y;Y;Y;Y;Y;Y;Y;Y;Y;Y;Y;0;0;0;0;0;0;0;0;0;0;0;0;0;0;0;0;0;0;Y;Y;Y
Y;0;0;0;0;0;0;0;0;0;0;0;0;0;Y;Y;Y;Y;Y;Y;Y;Y;Y;Y;0;0;0;0;0;0;0;0;0;0;0;0;0;0;0;0;0;0;0;Y;Y;Y
Y;Y;Y;Y;Y;Y;Y;Y;Y;Y;0;0;0;0;Y;Y;Y;Y;Y;Y;Y;Y;Y;Y;0;0;0;0;Y;Y;Y;Y;Y;Y;Y;Y;Y;Y;Y;Y;Y;Y;Y;Y;Y;Y
Y;Y;Y;Y;Y;Y;Y;Y;Y;Y;0;0;0;0;0;Y;Y;Y;Y;Y;Y;Y;Y;0;0;0;0;0;Y;Y;Y;Y;Y;Y;Y;Y;Y;Y;Y;Y;Y;Y;Y;Y;Y;Y
Y;Y;Y;Y;Y;Y;Y;Y;Y;Y;Y;0;0;0;0;Y;Y;Y;Y;Y;Y;Y;Y;0;0;0;0;Y;Y;Y;Y;Y;Y;Y;Y;Y;Y;Y;Y;Y;Y;Y;Y;Y;Y;Y
Y;Y;Y;Y;Y;Y;Y;Y;Y;Y;Y;0;0;0;0;0;Y;Y;Y;Y;Y;Y;0;0;0;0;0;Y;Y;Y;Y;Y;Y;Y;Y;Y;Y;Y;Y;Y;Y;Y;Y;Y;Y;Y
Y;Y;Y;Y;Y;Y;Y;Y;Y;Y;Y;Y;0;0;0;0;Y;Y;Y;Y;Y;Y;0;0;0;0;Y;Y;Y;Y;Y;Y;Y;Y;Y;Y;Y;Y;Y;Y;Y;Y;Y;Y;Y;Y
Y;Y;Y;Y;Y;Y;Y;Y;Y;Y;Y;Y;0;0;0;0;0;Y;Y;Y;Y;0;0;0;0;0;Y;Y;Y;Y;Y;Y;Y;Y;Y;Y;Y;Y;Y;Y;Y;Y;Y;Y;Y;Y
Y;Y;Y;Y;Y;Y;Y;Y;Y;Y;Y;Y;Y;0;0;0;0;Y;Y;Y;Y;0;0;0;0;Y;Y;Y;Y;Y;Y;Y;Y;Y;Y;Y;Y;Y;Y;Y;Y;Y;Y;Y;Y;Y
Y;Y;Y;Y;Y;Y;Y;Y;Y;Y;Y;Y;Y;0;0;0;0;0;Y;Y;0;0;0;0;0;Y;Y;Y;Y;Y;Y;Y;Y;Y;Y;Y;Y;Y;Y;Y;Y;Y;Y;Y;Y;Y
Y;Y;Y;Y;Y;Y;Y;Y;Y;Y;Y;Y;Y;Y;0;0;0;0;Y;Y;0;0;0;0;Y;Y;Y;Y;Y;Y;Y;Y;Y;Y;Y;Y;Y;Y;Y;Y;Y;Y;Y;Y;Y;Y
Y;Y;Y;Y;Y;Y;Y;Y;Y;Y;Y;Y;Y;Y;0;0;0;0;0;0;0;0;0;0;Y;Y;Y;Y;Y;Y;Y;Y;Y;Y;Y;Y;Y;Y;Y;Y;Y;Y;Y;Y;Y;Y
Y;Y;Y;Y;Y;Y;Y;Y;Y;Y;Y;Y;Y;Y;Y;0;0;0;0;0;0;0;0;Y;Y;Y;Y;Y;Y;Y;Y;Y;Y;Y;Y;Y;Y;Y;Y;Y;Y;Y;Y;Y;Y;Y
Y;Y;Y;Y;Y;Y;Y;Y;Y;Y;Y;Y;Y;Y;Y;0;0;0;0;0;0;0;0;Y;Y;Y;Y;Y;Y;Y;Y;Y;Y;Y;Y;Y;Y;Y;Y;Y;Y;Y;Y;Y;Y;Y
Y;Y;Y;Y;Y;Y;Y;Y;Y;Y;Y;Y;Y;Y;Y;Y;0;0;0;0;0;0;Y;Y;Y;Y;Y;Y;Y;Y;Y;Y;Y;Y;Y;Y;Y;Y;Y;Y;Y;Y;Y;Y;Y;Y
Y;Y;Y;Y;Y;Y;Y;Y;Y;Y;Y;Y;Y;Y;Y;Y;0;0;0;0;0;0;Y;Y;Y;Y;Y;Y;Y;Y;Y;Y;Y;Y;Y;Y;Y;Y;Y;Y;Y;Y;Y;Y;Y;Y
Y;Y;Y;Y;Y;Y;Y;Y;Y;Y;Y;Y;Y;Y;Y;Y;Y;0;0;0;0;Y;Y;Y;Y;Y;Y;Y;Y;Y;Y;Y;Y;Y;Y;Y;Y;Y;Y;Y;Y;Y;Y;Y;Y;Y
Y;Y;Y;Y;Y;Y;Y;Y;Y;Y;Y;Y;Y;Y;Y;Y;Y;Y;Y;Y;Y;Y;Y;Y;Y;Y;Y;Y;Y;Y;Y;Y;Y;Y;Y;Y;Y;Y;Y;Y;Y;Y;Y;Y;Y;Y
Y;Y;Y;Y;Y;Y;Y;Y;Y;Y;Y;Y;Y;Y;Y;Y;Y;Y;Y;Y;Y;Y;Y;Y;Y;Y;Y;Y;Y;Y;Y;Y;Y;Y;Y;Y;Y;Y;Y;Y;Y;Y;Y;Y;Y;Y
Y;Y;Y;Y;Y;Y;Y;Y;Y;Y;Y;Y;Y;Y;Y;Y;Y;Y;Y;Y;Y;Y;Y;Y;Y;Y;Y;Y;Y;Y;Y;Y;Y;Y;Y;Y;Y;Y;Y;Y;Y;Y;Y;Y;Y;Y
Y;Y;Y;Y;Y;Y;Y;Y;Y;Y;Y;Y;Y;Y;Y;Y;Y;Y;Y;Y;Y;Y;Y;Y;Y;Y;Y;Y;Y;Y;Y;Y;Y;Y;Y;Y;Y;Y;Y;Y;Y;Y;Y;Y;Y;Y
