n;n;n;n;n;n;n;n;n;n;n;n;n;n;n;n;n;n;n;n;n;n;n;n;n;n;n;n;n;n;n;n;n;n;n;n;n;n;n;n
n;n;n;n;n;n;n;n;n;n;n;n;n;n;n;n;n;n;n;n;n;n;n;n;n;n;n;n;n;n;n;n;n;n;n;n;n;n;n;n
n;n;n;n;0;0;n;0;0;n;0;0;n;0;0;n;0;0;n;0;0;n;0;0;n;0;0;n;0;0;n;n;n;n;n;n;n;n;n;n
n;n;n;n;0;0;n;0;0;n;0;0;n;0;0;n;0;0;n;0;0;n;0;0;n;0;0;n;0;0;n;n;n;n;n;n;n;n;n;n
n;n;n;n;n;n;n;n;n;n;n;n;n;n;n;n;n;n;n;n;n;n;n;n;n;n;n;n;n;n;n;n;n;n;n;n;n;n;n;n
n;n;n;n;n;n;n;n;n;n;n;n;n;n;n;n;n;n;n;0;0;0;0;0;0;0;0;0;0;0;0;n;n;n;n;n;n;n;n;n
n;n;n;n;n;n;n;n;n;n;n;n;n;n;n;n;0;0;0;0;0;0;0;0;0;0;0;0;0;0;0;n;n;n;n;n;n;n;n;n
n;n;n;n;0;0;0;0;n;n;n;n;n;n;n;n;0;0;0;0;0;0;0;0;0;0;0;0;0;0;0;n;n;n;n;n;n;n;n;n
n;n;n;n;0;0;0;0;n;n;n;n;n;n;n;n;0;0;0;0;0;0;0;0;0;0;0;0;0;0;0;n;n;n;n;n;n;n;n;n
n;n;n;n;0;0;0;0;n;n;n;n;n;n;n;n;0;0;0;0;0;0;0;0;0;0;0;0;0;0;0;n;n;n;n;n;n;n;n;n
n;n;n;n;0;0;0;0;n;n;n;n;n;n;n;n;0;0;0;0;0;0;0;0;0;0;0;0;0;0;0;n;n;n;n;n;n;n;n;n
n;n;n;n;0;0;0;0;0;0;0;0;0;0;0;0;0;0;0;0;0;0;0;0;0;0;0;0;0;0;0;n;n;n;n;n;n;n;n;n
n;n;n;n;0;0;0;0;0;0;0;0;0;0;0;0;0;0;0;0;0;0;0;0;0;0;0;0;0;0;0;n;n;n;n;n;n;n;n;n
n;n;n;n;0;0;0;0;0;0;0;0;0;0;0;0;0;0;0;0;0;0;0;0;0;0;0;0;0;0;0;n;n;n;n;n;n;n;n;n
n;n;n;n;0;0;0;0;0;0;0;0;0;0;0;0;0;0;0;0;0;0;0;0;0;0;0;0;0;0;0;n;n;n;n;n;n;n;n;n
n;n;n;n;0;0;0;0;0;0;0;0;0;0;0;0;0;0;0;0;0;0;0;0;0;0;0;0;0;0;0;n;n;n;n;n;n;n;n;n
n;n;n;n;0;0;0;0;0;0;0;0;0;0;0;0;0;0;0;0;0;0;0;0;0;0;0;0;0;0;0;n;n;n;n;n;n;n;n;n
n;n;n;n;0;0;0;0;0;0;0;0;0;0;0;0;0;0;0;0;0;0;0;0;0;0;0;0;0;0;0;n;n;n;n;n;n;n;n;n
n;n;n;n;0;0;0;0;0;0;0;0;0;0;0;0;0;0;0;0;0;0;0;0;0;0;0;0;0;0;0;n;n;n;n;n;n;n;n;n
n;n;n;n;0;0;0;0;0;0;0;0;0;0;0;0;0;0;0;0;0;0;0;0;0;0;0;0;0;0;0;n;n;n;n;n;n;n;n;n
n;n;n;n;0;0;0;0;0;0;0;0;0;0;0;0;0;0;0;0;0;0;0;0;0;0;0;0;0;0;0;n;n;n;n;n;n;n;n;n
n;n;n;n;0;0;0;0;0;0;0;0;0;0;0;0;0;0;0;0;0;0;0;0;0;0;0;0;0;0;0;n;n;n;n;n;n;n;n;n
n;n;n;n;0;0;0;0;0;0;0;0;0;0;0;0;0;0;0;0;0;0;0;0;0;0;0;0;0;0;0;n;n;n;n;n;n;n;n;n
n;n;n;n;0;0;0;0;0;0;0;0;0;0;0;0;0;0;0;0;0;0;0;0;0;0;0;0;0;0;0;n;n;n;n;n;n;n;n;n
n;n;n;n;0;0;0;0;0;0;0;0;0;0;0;0;0;0;0;0;0;0;0;0;0;0;0;0;0;0;0;n;n;n;n;n;n;n;n;n
n;n;n;n;0;0;0;0;0;0;0;0;0;0;0;0;0;0;0;0;0;0;0;0;0;0;0;0;0;0;0;n;n;n;n;n;n;n;n;n
n;n;n;n;0;0;0;0;0;0;0;0;0;0;0;0;0;0;0;0;0;0;0;0;0;0;0;0;0;0;0;n;n;n;n;n;n;n;n;n
n;n;n;n;0;0;0;0;0;0;0;0;0;0;0;0;0;0;0;0;0;0;0;0;0;0;0;0;0;0;0;n;n;n;n;n;n;n;n;n
n;n;n;n;0;0;0;0;0;0;0;0;0;0;0;0;0;0;0;0;0;0;0;0;0;0;0;0;0;0;0;n;n;n;n;n;n;n;n;n
n;n;n;n;0;0;0;0;0;0;0;0;0;0;0;0;0;0;0;0;0;0;0;0;0;0;0;n;n;n;n;n;n;n;n;n;n;n;n;n
n;n;n;n;0;0;0;0;0;0;0;0;0;0;0;0;0;0;0;0;0;0;0;0;0;0;0;n;n;n;n;n;n;n;n;n;n;n;n;n
n;n;n;n;0;0;0;0;0;0;0;0;0;0;0;0;0;0;0;0;0;0;0;0;0;0;0;n;n;n;n;n;n;n;n;n;n;n;n;n
n;n;n;n;0;0;0;0;0;0;0;0;0;0;0;0;0;0;0;0;0;0;0;0;0;0;n;n;n;n;n;n;n;n;n;n;n;n;n;n
n;n;n;n;0;0;0;0;0;0;0;0;0;0;0;0;0;0;0;0;0;0;0;0;0;0;n;n;n;n;n;n;n;n;n;n;n;n;n;n
n;n;n;n;0;0;0;0;0;0;0;0;0;0;0;0;0;0;0;0;0;0;0;0;0;0;n;n;n;n;n;n;n;n;n;n;n;n;n;n
n;n;n;n;0;0;0;0;0;0;0;0;0;0;0;0;0;0;0;0;0;0;0;0;0;0;n;n;n;n;n;n;n;n;n;n;n;n;n;n
n;n;n;n;0;0;0;0;0;0;0;0;0;0;0;0;0;0;0;0;0;0;0;0;0;0;n;n;n;n;n;n;n;n;n;n;n;n;n;n
n;n;n;n;0;0;0;0;0;0;0;0;0;0;0;0;0;0;0;0;0;0;0;0;0;0;n;n;n;n;n;n;n;n;n;n;n;n;n;n
n;n;n;n;0;0;0;0;0;0;0;0;0;0;0;0;0;0;0;0;0;0;0;0;0;0;n;n;n;n;n;n;n;n;n;n;n;n;n;n
n;n;n;n;0;0;0;0;0;0;0;0;0;0;0;0;0;0;0;0;0;0;0;0;0;0;n;n;n;n;n;n;n;n;n;n;n;n;n;n
n;n;n;n;0;0;0;0;0;0;0;0;0;0;0;0;0;0;0;0;0;0;0;0;0;0;n;n;n;n;n;n;n;n;n;n;n;n;n;n
n;n;n;n;0;0;0;0;0;0;0;0;0;0;0;0;0;0;0;0;0;0;0;0;0;0;n;n;n;n;n;n;n;n;n;n;n;n;n;n
n;n;n;n;0;0;0;0;0;0;0;0;0;0;0;0;0;0;0;0;0;0;0;0;0;0;0;0;0;0;0;0;0;0;0;0;n;n;n;n
n;n;n;n;0;0;0;0;0;0;0;0;0;0;0;0;0;0;0;0;0;0;0;0;0;0;0;0;0;0;0;0;0;0;0;0;n;n;n;n
n;n;n;n;0;0;0;0;0;0;0;0;0;0;0;0;0;0;0;0;0;0;0;0;0;0;0;0;0;0;0;0;0;0;0;0;n;n;n;n
n;n;n;n;0;0;0;0;0;0;0;0;0;0;0;0;0;0;0;0;0;0;0;0;0;0;0;0;0;0;0;0;0;0;0;0;n;n;n;n
n;n;n;n;0;0;0;0;0;0;0;0;0;0;0;0;0;0;0;0;0;0;0;0;0;0;0;0;0;0;0;0;0;0;0;0;n;n;n;n
n;n;n;n;0;0;0;0;n;n;n;n;0;0;0;0;0;0;0;0;0;0;0;0;0;0;0;0;0;0;0;0;0;0;0;0;n;n;n;n
n;n;n;n;0;0;0;0;n;n;n;n;0;0;0;0;0;0;0;0;0;0;0;0;0;0;0;0;0;0;0;0;0;0;0;0;n;n;n;n
n;n;n;n;0;0;0;0;n;n;n;n;n;n;n;n;n;n;n;n;n;n;n;n;n;n;n;n;n;n;n;n;n;n;n;n;n;n;n;n
n;n;n;n;0;0;0;0;n;n;n;n;n;n;n;n;n;n;n;n;n;n;n;n;n;n;n;n;n;n;n;n;n;n;n;n;n;n;n;n
