J;J;J;F;F;F;F;F;F;];];];];];];];];];];];];Z;Z;Z;Z;Z;Z;Z;Z;0;0;Z;Z;Z;Z;Z;Z;Z;Z;Z
J;J;J;F;F;F;F;F;F;];];];];];];];];];];];];Z;Z;Z;Z;Z;Z;Z;Z;0;0;0;0;0;0;0;0;0;0;0
J;F;F;F;F;F;F;F;F;];];];];];];];];];];];];Z;Z;Z;Z;Z;Z;Z;Z;0;0;0;0;0;0;0;0;0;0;0
J;F;F;F;F;F;F;F;F;];];];];];];];];];];];];];0;0;0;F;F;F;0;0;0;0;0;0;0;0;0;0;0;0
J;F;F;F;F;F;F;F;F;];];];];];];];];];];];];];0;0;0;F;F;F;0;0;0;0;0;0;0;0;0;0;0;0
J;F;F;F;F;F;F;F;F;];];];];];];];];];];];];];0;0;0;0;0;0;0;0;0;0;0;0;0;0;Z;Z;Z;Z
J;F;F;F;F;F;F;F;F;[;[;[;[;[;[;[;[;[;[;[;[;[;0;0;0;0;0;0;0;0;0;0;0;0;0;0;Z;Z;Z;Z
J;F;F;F;F;F;F;F;F;F;0;0;0;0;0;0;0;F;F;F;F;F;0;0;0;0;0;0;0;0;0;0;0;0;0;0;Z;Z;Z;Z
J;F;F;F;F;F;F;F;F;F;0;0;0;0;0;0;0;F;F;F;F;F;0;0;0;0;0;0;0;0;0;0;0;0;0;0;Z;Z;Z;Z
J;J;J;F;F;F;F;F;F;F;0;0;0;0;0;0;0;F;F;F;F;F;0;0;0;0;0;0;0;0;0;0;0;0;0;0;Z;Z;Z;Z
J;J;J;J;J;F;F;0;0;0;0;0;0;0;0;0;0;0;0;0;0;0;0;0;0;0;0;0;0;0;0;0;0;J;J;J;Z;Z;Z;Z
J;J;J;J;0;F;F;0;0;0;0;0;0;0;0;0;0;0;0;0;0;0;0;0;0;0;0;0;0;0;0;0;J;J;J;J;Z;Z;Z;Z
J;J;J;J;0;0;0;0;0;0;0;0;0;0;0;0;0;0;0;0;0;0;0;0;0;0;0;0;0;0;0;J;J;J;J;J;Z;Z;Z;Z
J;J;J;J;0;0;0;0;0;0;0;0;0;0;0;0;0;0;0;0;0;0;0;0;0;0;0;0;0;0;J;J;J;J;J;J;J;J;J;Z
J;J;J;J;0;0;0;0;0;J;J;0;0;0;0;0;0;0;0;0;0;J;J;J;J;0;0;0;0;J;J;J;J;J;J;J;J;J;J;J
J;J;J;J;0;0;0;0;0;J;J;0;0;0;0;J;J;J;J;J;J;J;J;J;J;0;J;J;J;J;J;J;J;J;J;J;J;J;J;J
J;J;J;J;J;0;0;0;0;J;J;0;0;0;0;J;J;Z;Z;Z;Z;J;J;J;J;0;J;J;J;J;J;J;J;J;J;J;J;J;J;J
J;J;J;J;J;0;0;0;0;J;J;0;0;0;0;0;0;Z;Z;Z;Z;J;J;J;J;0;J;J;J;J;J;J;J;J;J;J;J;J;J;J
J;J;J;J;J;0;0;0;0;0;0;0;0;0;0;0;0;Z;Z;Z;Z;J;J;J;J;0;J;J;J;J;J;J;J;J;J;J;J;J;J;J
0;0;0;0;0;0;0;0;0;0;0;0;0;0;0;0;0;Z;Z;Z;Z;J;J;J;J;0;J;J;J;J;J;J;J;J;J;J;J;J;J;J
0;0;0;0;0;0;0;0;0;0;0;0;0;0;0;0;0;Z;Z;Z;Z;J;J;J;J;0;J;J;J;J;J;J;J;J;J;J;J;J;J;J
0;0;0;0;0;0;0;0;0;0;0;0;0;0;0;0;0;Z;Z;Z;Z;J;J;J;J;0;J;J;J;J;Z;Z;Z;Z;Z;Z;Z;Z;J;J
0;0;0;0;0;0;0;0;0;0;0;0;0;0;0;0;0;0;0;0;J;J;J;J;J;0;0;J;J;J;Z;Z;Z;Z;Z;Z;Z;Z;J;J
J;J;J;J;J;J;J;0;0;0;0;0;0;0;0;0;0;0;0;0;J;J;J;J;J;0;0;J;J;J;Z;Z;Z;Z;Z;Z;Z;Z;J;J
J;J;J;J;J;J;J;0;0;0;0;0;0;0;0;0;0;0;0;0;0;0;0;0;0;0;0;0;0;0;Z;Z;Z;Z;Z;Z;Z;Z;J;J
J;J;J;J;J;J;J;0;0;0;0;0;0;0;0;0;0;0;0;0;0;0;0;0;0;0;0;0;0;0;Z;Z;Z;Z;Z;Z;Z;Z;J;J
J;J;J;J;J;J;J;0;0;0;0;0;0;0;0;0;0;0;0;0;0;0;0;0;0;0;0;0;0;0;Z;Z;Z;Z;Z;Z;Z;Z;J;J
J;J;J;J;J;J;J;0;0;0;0;0;0;0;0;0;0;0;0;0;0;0;0;0;0;0;0;0;0;0;Z;Z;Z;Z;Z;Z;Z;Z;J;J
J;J;J;J;J;J;J;0;0;0;0;0;0;0;J;J;J;J;J;J;0;0;0;0;0;0;0;0;0;0;0;J;0;0;0;J;J;J;J;J
J;J;J;J;J;0;0;0;0;0;0;0;0;0;J;J;J;J;J;J;J;0;0;0;0;0;0;0;0;0;0;0;0;0;0;J;J;J;J;J
J;J;J;J;0;0;0;0;0;0;0;0;0;0;J;J;J;J;J;J;J;J;0;0;0;0;0;0;0;0;0;0;0;0;0;J;J;J;J;J
J;J;J;0;0;0;0;0;0;0;0;0;0;0;J;J;J;J;J;J;J;J;J;0;0;0;0;0;0;0;0;0;0;0;0;J;J;J;J;J
0;0;0;0;0;0;0;0;0;0;0;0;0;0;J;J;J;J;J;J;J;J;J;J;J;J;J;J;J;0;0;0;0;0;0;0;0;J;J;J
0;0;0;0;0;0;0;0;0;0;0;0;0;0;J;J;J;J;J;J;J;J;J;J;J;J;J;J;J;0;0;0;0;0;0;0;0;0;J;J
0;0;0;0;0;0;0;0;0;0;0;0;0;0;J;J;J;J;J;J;J;J;J;J;J;J;J;J;J;0;0;0;0;0;0;0;0;0;0;J
0;0;0;0;0;0;0;0;0;0;0;0;0;0;J;J;J;J;J;J;J;J;J;J;J;J;J;J;J;0;0;0;0;0;0;0;0;0;0;0
0;0;0;0;0;0;0;0;0;0;0;0;0;0;J;J;J;J;J;J;0;0;0;J;J;J;J;J;J;0;0;0;0;0;0;0;0;0;0;0
0;0;0;0;0;0;0;0;0;0;0;0;0;0;J;J;J;J;J;0;0;0;0;0;J;J;J;J;J;0;0;0;0;0;0;0;0;0;0;0
0;0;0;0;0;0;0;0;0;0;0;0;0;0;0;0;0;0;0;0;0;0;0;0;J;J;J;J;J;0;0;0;0;0;0;0;0;0;0;0
0;0;0;0;0;0;0;0;0;0;0;0;0;0;0;0;0;0;0;0;0;0;0;0;J;J;J;J;J;0;0;0;0;0;0;0;[;[;[;[
0;0;0;0;0;0;0;0;0;0;0;0;0;0;0;0;0;0;0;0;0;0;0;0;J;J;J;J;0;0;0;0;0;0;0;0;[;[;[;[
0;0;0;0;0;0;0;0;0;0;0;0;0;0;0;0;0;0;0;0;0;0;0;0;J;J;J;J;0;0;0;0;0;0;0;0;0;0;0;0
0;0;0;0;0;0;0;0;0;0;0;0;0;0;0;0;0;0;0;0;0;0;0;0;0;0;0;0;0;0;0;0;0;0;0;0;0;0;0;0
0;0;0;0;0;0;0;0;0;0;0;0;0;0;0;0;0;0;0;0;0;0;0;0;0;0;0;0;0;0;0;0;0;0;0;0;0;0;0;0
