1 1 1 1 1 1 1 1 1 1 1 1 1 1 1 1 1 1 1 1 1 1 1 1 1 1 1 1 1 1 1 1 1 1 1 1 1 1 1 1
1 0 0 0 0 0 0 0 0 0 0 0 0 0 0 0 0 0 0 0 0 0 0 0 0 0 0 0 0 0 0 0 0 0 0 0 0 0 0 1
1 0 0 0 0 0 0 0 0 0 0 0 0 0 0 0 0 0 0 0 0 0 0 0 0 0 0 0 0 0 0 0 0 0 0 0 0 0 0 0
1 0 0 0 0 0 0 0 0 0 0 0 0 0 0 0 0 0 0 0 0 0 0 0 0 0 0 0 0 0 0 0 0 0 0 0 0 0 0 0
1 0 0 0 0 0 0 0 0 0 0 0 0 0 0 0 0 0 0 0 0 0 0 0 0 0 0 0 0 0 0 0 0 0 0 0 0 0 0 0
1 0 0 0 0 0 0 0 0 0 0 0 0 0 0 0 0 0 0 0 0 0 0 0 0 0 0 0 0 0 0 0 0 0 0 0 0 0 0 0
0 0 0 0 ^ ^ ^ ^ 0 0 0 0 0 0 0 0 0 1 1 1 1 1 1 1 1 1 0 0 0 0 0 0 0 0 0 0 0 0 0 0
0 0 0 0 1 1 1 1 0 0 0 0 0 0 0 0 0 1 1 1 1 1 1 1 1 1 0 0 0 0 0 0 0 0 0 0 0 0 0 0
0 0 0 0 1 1 1 1 0 0 0 0 0 0 0 0 0 1 1 1 1 1 1 1 1 1 0 0 0 0 0 0 0 0 0 0 0 0 0 0
0 0 P 0 1 1 1 1 0 0 0 0 0 0 0 0 0 1 1 1 1 1 1 1 1 1 0 0 0 0 0 0 0 0 0 0 0 P 0 0
0 0 0 0 1 1 1 1 1 1 1 1 1 1 1 1 1 1 1 1 1 1 1 1 1 1 0 0 0 0 0 0 0 0 0 0 0 0 0 0
1 0 0 0 D D D D D D D D D D D D D D D D D D D D D D 0 0 0 _ _ _ _ 1 1 1 1 0 0 0
1 0 0 0 D D D D D D D D D D D D D D D D D D D D D D 0 0 0 0 0 0 0 1 1 1 1 0 0 0
1 0 0 0 D D D D D D D D D D D D D D D D D D D D D D 0 0 0 0 1 1 1 1 1 1 1 0 0 0
1 0 0 0 D D D D D D D D D D D D D D D D D D D D D D 0 0 0 0 1 1 1 1 1 1 1 0 0 0
1 0 0 0 D D D D D D D D D D D D D D D D D D D D D D 0 0 0 0 1 1 1 1 1 1 1 0 0 0
1 0 0 0 D D D D D D D D D D D D D D D D D D D D D D 0 0 0 0 1 1 1 1 1 1 1 0 0 0
1 0 0 0 D D D D D D D D D D D D D D D D D D D D D D 0 0 0 0 0 0 0 1 1 1 1 0 0 0
1 0 0 0 D D D D D D D D D D D D D D D D D D D D D D 0 0 0 0 0 0 0 1 1 1 1 0 0 0
1 0 0 0 D D D D D D D D D D D D D D D D D D D D D D 0 0 0 0 0 0 0 0 0 0 0 0 0 0
1 0 0 0 D D D D D D D D D D D D D D D D D D D D D D 0 0 0 0 0 0 0 0 0 0 0 0 0 0
1 0 0 0 D D D D D D D D D D D D D D D D D D D D D D 0 0 0 0 0 0 0 0 0 0 0 0 0 0
1 1 1 0 D D D D D D D D D D D D D D D D D D D D D D 0 0 0 0 0 0 0 0 0 0 0 0 0 0
