0;0;0;0;0;0;0;0;0;0;0;0;0;k;k;k;k;k;k
0;0;0;0;0;0;0;0;0;0;0;0;0;k;k;k;k;Ʊ;Ʊ
0;0;0;0;0;0;0;0;0;0;k;k;k;k;k;k;k;Ʊ;Ʊ
0;0;0;0;0;0;0;0;0;0;k;k;k;k;k;k;í;í;Ʊ
0;0;0;0;0;0;0;0;k;k;k;k;k;k;k;í;í;í;í
0;0;0;0;0;0;0;0;k;k;k;k;k;k;k;í;í;í;í
