1 1 1 1 1 1 1 1 1 1 1 1 1 1 1 1 1 1 1 1 1 1 1 1 1 1 1 1 1 1 1 1 1 1 1 1 1 1 1 1
1 0 0 0 0 0 0 0 0 0 0 0 0 0 0 0 0 0 0 0 0 0 0 0 0 0 0 0 0 0 0 0 0 0 0 0 0 0 0 1
1 0 0 0 0 0 0 0 0 0 0 0 0 0 0 0 0 0 0 0 0 0 0 0 S 0 0 0 0 0 0 0 0 0 0 0 0 0 0 1
1 0 0 0 0 0 0 S W W W W W W W W W W W W W W W W W W W W W W W W W W W W W W W W
1 0 0 0 0 0 0 S W W W W W W W S W S W W W W W W W W W W W W W W S W W W S W W W
1 0 0 0 0 0 0 S W W W W W W W W S W W W W W W W W W W W W W W W W W W W W W W W
0 0 0 0 0 0 0 S W W W W W W W S W W W W W W W W W W W W W W W W W W W W W W W 0
0 0 0 0 0 0 0 S W W W W W W W W W W W W W W W W W W W W W W W W W W W W W W W 0
0 0 0 0 0 0 0 S W W W W W W W W W W W W W W W W W W W W W W W W W W W W 0 0 0 0
0 0 P 0 0 0 0 S W W W W W W W W W W W W W W W W W W W W W W W W W W W W 0 P 0 0
0 0 0 0 0 0 0 S W W W W W S S W W W W W W W W W W W W W W W W W W W W W 0 0 0 0
1 0 0 0 0 0 0 S W W W W W W W S W W W W W W W W W W W W W W W W W W W W W W W W
1 0 0 0 0 0 0 S W W W W W W W W W W W W W W W W W W W W W W W W W W W W W W W W
1 0 0 0 0 0 0 S W W W W W W W W W W W W W W W W W W W W W W W W W W W W W W W W
1 0 0 0 0 0 0 S W W W W W W W W W W W W W W W W W W W W W W W W W W W W W W W W
1 0 0 0 0 0 0 S W W W W W W W W W W W W W W W W W W W W W W W W W W W W W W W W
1 0 0 0 0 0 0 S W W W W W W W W W W W W W W W W W W W W W W W W W W W W W W W W
1 0 0 0 0 0 0 S W W W W W W W W W W W W W W W W W W W W W W W W W W W W W W W W
1 0 0 0 0 0 0 S W W W W W W W W W W W W W W W W W W W W W W W W W W W W W W W W
1 0 0 0 0 0 0 S W W W W W W W W W W W W W W W W W W W W W W W W W W W W W W W W
1 0 0 0 0 0 0 S W W W W W W W W W W W W W W W W W W W W W W W W W W W W W W W W
1 0 0 0 0 0 0 S W W W W W W W W W W W W W W W W W W W W W W W W W W W W W W W W
1 1 1 1 1 1 0 S W W W W W W W W S W W W W W W W W W W W W W W W W W W W W W W W
