Z;Z;Z;Z;Z;Z;Z;Z;Z;Z;Z;Z;Z;Z;Z;Z;Z;Z;Z;Z;Z;Z;Z;Z;Z;Z;Z;Z;Z;Z;Z;Z;Z;Z;Z;Z;Z;Z;Z;Z;0;0;0;0;0;0;0;0;0;0;Z;Z;Z;Z;Z;Z;Z;Z;Z;Z;Z;Z;Z;Z;Z;Z;Z;Z;Z;Z;Z;Z;Z;Z;Z;Z;Z;Z
Z;Z;Z;Z;Z;Z;Z;Z;Z;Z;Z;Z;Z;Z;Z;Z;Z;Z;Z;Z;Z;Z;Z;Z;Z;Z;Z;Z;Z;Z;Z;Z;Z;Z;Z;Z;Z;Z;Z;Z;0;0;0;0;0;0;0;0;0;0;Z;Z;Z;Z;Z;Z;Z;Z;Z;Z;Z;Z;Z;Z;Z;Z;Z;Z;Z;Z;Z;Z;Z;Z;Z;Z;Z;Z
Z;0;0;0;0;0;0;0;0;0;0;0;0;0;0;0;0;0;0;0;0;0;0;0;0;0;0;0;0;0;0;0;0;0;0;0;0;0;0;0;0;0;0;0;0;0;0;0;0;0;Z;Z;Z;Z;Z;Z;Z;Z;Z;Z;Z;Z;Z;Z;Z;Z;Z;Z;Z;Z;Z;Z;Z;Z;Z;Z;Z;Z
Z;0;0;0;0;0;0;0;0;0;0;0;0;0;0;0;0;0;0;0;0;0;0;0;0;0;0;0;0;0;0;0;0;0;0;0;0;0;0;0;0;0;0;0;0;0;0;0;0;0;Z;Z;Z;Z;Z;Z;Z;Z;Z;Z;Z;Z;Z;Z;Z;Z;Z;Z;Z;Z;Z;Z;Z;Z;Z;Z;Z;Z
Z;0;0;0;0;0;0;0;0;0;0;0;0;0;0;0;0;0;0;0;0;0;0;0;0;0;0;0;0;0;0;0;0;0;0;0;0;0;0;0;0;0;0;0;0;0;0;0;0;0;0;Z;Z;Z;Z;Z;Z;Z;Z;Z;Z;Z;Z;Z;Z;Z;Z;Z;Z;Z;Z;Z;Z;Z;Z;Z;Z;Z
Z;0;0;0;0;0;0;0;0;0;0;0;0;0;0;0;0;0;0;0;0;0;0;0;0;0;0;0;0;0;0;0;0;0;0;0;0;0;0;0;0;0;0;0;0;0;0;0;0;0;0;Z;Z;Z;Z;Z;Z;Z;Z;Z;Z;Z;Z;Z;Z;Z;Z;Z;Z;Z;Z;Z;Z;Z;Z;Z;Z;Z
Z;0;0;0;0;0;Z;Z;Z;Z;Z;Z;Z;Z;Z;Z;Z;Z;Z;Z;Z;Z;Z;Z;Z;Z;Z;Z;Z;Z;Z;Z;Z;Z;Z;Z;Z;0;0;0;0;0;0;0;0;0;0;0;0;0;0;Z;Z;Z;Z;Z;Z;Z;Z;Z;Z;Z;Z;Z;Z;Z;Z;Z;Z;Z;Z;Z;Z;Z;Z;Z;Z;Z
Z;0;0;0;0;0;Z;Z;Z;Z;Z;0;0;0;0;0;0;0;0;0;Z;Z;Z;Z;Z;Z;Z;Z;Z;Z;Z;Z;Z;Z;Z;Z;Z;0;0;0;0;0;0;0;0;0;0;0;0;0;0;Z;Z;Z;Z;Z;Z;Z;Z;Z;Z;Z;Z;Z;Z;Z;Z;Z;Z;Z;Z;Z;Z;Z;Z;Z;Z;Z
Z;0;0;0;0;0;Z;Z;Z;Z;0;0;0;0;0;0;0;0;0;0;0;0;0;0;Z;Z;Z;Z;Z;Z;Z;Z;Z;Z;Z;Z;Z;0;0;0;0;0;0;0;0;Z;Z;Z;Z;Z;Z;Z;Z;Z;Z;Z;Z;Z;Z;Z;Z;Z;Z;Z;Z;Z;Z;Z;Z;Z;Z;Z;Z;Z;Z;Z;Z;Z
0;0;0;0;0;0;0;0;0;Z;0;0;0;0;0;0;0;0;0;0;0;0;0;0;0;0;0;0;Z;Z;Z;Z;Z;Z;Z;Z;Z;0;0;0;0;0;0;0;0;Z;Z;Z;Z;Z;Z;Z;Z;Z;Z;Z;Z;Z;Z;Z;Z;Z;Z;Z;Z;Z;Z;Z;Z;Z;Z;Z;Z;Z;Z;Z;Z;Z
0;0;0;0;0;0;0;0;0;0;0;0;0;0;0;0;0;0;0;0;0;0;0;0;0;0;0;0;0;0;0;Z;Z;Z;Z;Z;0;0;0;0;0;0;0;0;0;0;Z;Z;Z;Z;Z;Z;Z;Z;Z;Z;Z;Z;Z;Z;Z;Z;Z;Z;Z;Z;Z;Z;Z;Z;Z;Z;Z;Z;Z;Z;Z;Z
0;0;0;0;0;0;0;0;0;0;0;0;0;0;0;0;0;0;0;0;0;0;0;0;0;0;0;0;0;0;0;0;0;0;0;0;0;0;0;0;0;0;0;0;0;0;0;0;Z;Z;Z;Z;Z;Z;Z;Z;Z;Z;Z;Z;Z;Z;Z;Z;Z;Z;Z;Z;Z;Z;Z;Z;Z;Z;Z;Z;Z;Z
0;0;0;0;0;0;0;0;0;0;0;0;0;0;0;0;0;0;0;0;0;0;0;0;0;0;0;0;0;0;0;0;0;0;0;0;0;0;0;0;0;0;0;0;0;0;0;0;0;0;0;Z;Z;Z;Z;Z;Z;Z;Z;Z;Z;Z;Z;Z;Z;Z;Z;Z;Z;Z;Z;Z;Z;Z;Z;Z;Z;Z
0;0;0;0;0;0;0;0;0;0;0;0;0;0;0;0;0;0;0;0;0;0;0;0;0;0;0;0;0;0;0;0;0;0;0;0;0;0;0;0;0;0;0;0;0;0;0;0;0;0;0;Z;Z;Z;Z;Z;Z;Z;Z;Z;Z;Z;Z;Z;Z;Z;Z;Z;Z;Z;Z;Z;Z;Z;Z;Z;Z;Z
0;0;0;0;0;0;0;0;0;0;0;0;0;0;0;0;0;0;0;0;0;0;0;0;0;0;0;0;0;0;0;0;0;0;0;0;0;0;0;0;0;0;0;0;0;0;0;0;0;0;0;Z;Z;Z;Z;Z;Z;Z;Z;Z;Z;Z;Z;Z;Z;Z;Z;Z;Z;Z;Z;Z;Z;Z;Z;Z;Z;Z
0;0;0;0;0;0;0;0;0;0;0;0;0;0;0;0;0;0;0;0;0;0;0;0;0;0;0;0;0;0;0;0;0;0;0;0;0;0;0;0;0;0;0;0;0;0;0;0;0;0;Z;Z;Z;Z;Z;Z;Z;Z;Z;Z;Z;Z;Z;Z;Z;Z;Z;Z;Z;Z;Z;Z;Z;Z;Z;Z;Z;Z
0;0;0;0;0;0;0;0;0;0;0;0;0;0;0;0;0;0;0;0;0;0;0;0;0;0;0;0;0;0;0;0;0;0;0;0;0;0;0;0;0;0;0;0;0;0;0;0;0;0;Z;Z;Z;Z;Z;Z;Z;Z;Z;Z;Z;Z;Z;Z;Z;Z;Z;Z;Z;Z;Z;Z;Z;Z;Z;Z;Z;Z
0;0;0;0;0;0;0;0;0;0;0;0;0;0;0;0;0;0;0;0;0;0;0;0;0;0;0;0;0;0;0;0;0;0;0;0;0;0;0;0;0;0;0;0;0;0;0;0;0;0;Z;Z;Z;Z;Z;Z;Z;Z;Z;Z;Z;Z;Z;Z;Z;Z;Z;Z;Z;Z;Z;Z;Z;Z;Z;Z;Z;Z
I;I;I;I;I;I;I;I;0;0;0;0;0;0;0;0;0;0;0;0;0;0;0;0;0;0;0;0;0;0;0;0;0;0;0;0;0;0;0;0;0;0;0;0;0;0;0;0;0;0;Z;Z;Z;Z;Z;Z;Z;Z;Z;Z;Z;Z;Z;Z;Z;Z;Z;Z;Z;Z;Z;Z;Z;Z;Z;Z;Z;Z
I;I;I;I;I;I;I;I;0;0;0;0;0;0;0;0;0;0;0;0;0;0;0;0;0;0;0;0;0;0;0;0;0;0;0;0;0;0;0;0;0;0;0;0;0;0;0;0;0;0;0;Z;Z;Z;Z;Z;Z;Z;Z;Z;Z;Z;Z;Z;Z;Z;Z;Z;Z;Z;Z;Z;Z;Z;Z;Z;Z;Z
I;I;I;I;I;I;I;I;0;0;0;0;0;0;0;0;0;0;0;0;0;0;0;0;0;0;0;0;0;0;0;0;0;0;0;0;0;0;0;0;0;0;0;0;0;0;0;0;0;0;0;0;0;Z;Z;Z;Z;Z;Z;Z;Z;Z;Z;Z;Z;Z;Z;Z;Z;Z;Z;Z;Z;Z;Z;Z;Z;Z
I;I;I;I;I;I;I;I;I;I;I;I;I;I;I;I;0;0;0;0;0;0;0;0;0;0;0;0;0;0;0;0;0;0;0;0;0;0;0;0;0;0;0;0;0;0;0;0;0;0;0;0;0;0;0;0;0;Z;Z;Z;Z;Z;Z;Z;Z;Z;Z;Z;Z;Z;Z;Z;Z;Z;Z;Z;Z;Z
I;I;I;I;I;I;I;I;I;I;I;I;I;I;I;I;I;I;I;I;0;0;0;0;0;0;0;0;0;0;0;0;0;0;0;0;0;0;0;0;0;0;0;0;0;0;0;0;0;0;0;0;0;0;0;0;0;Z;Z;Z;Z;Z;Z;Z;Z;Z;Z;Z;Z;Z;Z;Z;Z;Z;Z;Z;Z;Z
I;I;I;I;I;I;I;I;I;I;I;I;I;I;I;I;I;I;I;I;I;I;0;0;0;0;0;0;0;0;0;0;0;0;0;0;0;0;0;0;0;0;0;0;0;0;0;0;0;0;0;0;0;0;0;0;0;0;Z;Z;Z;Z;Z;Z;Z;Z;Z;Z;Z;Z;Z;Z;Z;Z;Z;Z;Z;Z
I;I;I;I;I;I;I;I;I;I;I;I;I;I;I;I;I;I;I;I;I;I;0;0;0;0;0;0;0;0;0;0;0;0;0;0;0;0;0;0;0;0;0;0;0;0;0;0;0;0;0;0;0;0;0;0;0;0;Z;Z;Z;Z;Z;Z;Z;Z;Z;Z;Z;Z;Z;Z;Z;Z;Z;Z;Z;Z
I;I;I;I;I;I;I;I;I;I;I;I;I;I;I;I;I;I;I;I;I;I;0;0;0;0;0;0;0;0;0;0;0;0;0;0;0;0;0;0;0;0;0;0;0;0;0;0;0;0;0;0;0;0;0;0;0;0;0;0;0;Z;Z;Z;Z;Z;Z;Z;Z;Z;Z;Z;Z;Z;Z;Z;Z;Z
I;I;I;I;I;I;I;I;I;I;I;I;I;I;I;I;I;I;I;I;I;I;0;0;0;0;0;0;0;0;0;0;0;0;0;0;0;0;0;0;0;0;0;0;0;0;0;0;0;0;0;0;0;0;0;0;0;0;0;0;0;0;0;0;0;0;0;Z;Z;Z;Z;Z;Z;Z;Z;Z;Z;Z
I;I;I;I;I;I;I;I;I;I;I;I;I;I;I;I;I;I;I;I;I;I;I;I;I;I;I;0;0;0;0;0;0;0;0;0;0;0;0;0;0;0;0;0;0;0;0;0;0;0;0;0;0;0;0;0;0;0;0;0;0;0;0;0;0;0;0;0;Z;Z;Z;Z;Z;Z;Z;Z;Z;Z
I;I;I;I;I;I;I;I;I;I;I;I;I;I;I;I;I;I;I;I;I;I;I;I;I;I;I;I;0;0;0;0;0;0;0;0;0;0;0;0;0;0;0;0;0;0;0;0;0;0;0;0;0;0;0;0;0;0;0;0;0;0;0;0;0;0;0;0;0;Z;Z;Z;0;Z;Z;Z;Z;Z
I;I;I;I;I;I;I;I;I;I;I;I;I;I;I;I;I;I;I;I;I;I;I;I;I;I;I;I;0;0;0;0;0;0;0;0;0;0;0;0;0;0;0;0;0;0;0;0;0;0;0;0;0;0;0;0;0;0;0;0;0;0;0;0;0;0;0;0;0;0;0;0;0;0;0;0;Z;Z
I;I;I;I;I;I;I;I;I;I;I;I;I;I;I;I;I;I;I;I;I;I;I;I;I;I;I;I;I;0;0;0;0;0;0;0;0;0;0;0;0;0;0;0;0;0;0;0;0;0;0;0;0;0;0;0;0;0;0;0;0;0;0;0;0;0;0;0;0;0;0;0;0;0;0;0;0;0
I;I;I;I;I;I;I;I;I;I;I;I;I;I;I;I;I;I;I;I;I;I;I;I;I;I;I;I;I;0;0;0;0;0;0;0;0;0;0;0;0;0;0;0;0;0;0;0;0;0;0;0;0;0;0;0;0;0;0;0;0;0;0;0;0;0;0;0;0;0;0;0;0;0;0;0;0;0
I;I;I;I;I;I;I;I;I;I;I;I;I;I;I;I;I;I;I;I;I;I;I;I;I;I;I;I;I;0;0;0;0;0;0;0;0;0;0;0;0;0;0;0;0;0;0;0;0;0;0;0;0;0;0;0;0;0;0;0;0;0;0;0;0;0;0;0;0;0;0;0;0;0;0;0;0;0
I;I;I;I;I;I;I;I;I;I;I;I;I;I;I;I;I;I;I;I;I;I;I;I;I;I;I;I;I;0;0;0;0;0;0;0;0;0;0;0;0;0;0;0;0;0;0;0;0;0;0;0;0;0;0;0;0;0;0;0;0;0;0;0;0;0;0;0;0;0;0;0;0;0;0;0;0;0
I;I;I;I;I;I;I;I;I;I;I;I;I;I;I;I;I;I;I;I;I;I;I;I;I;I;I;I;I;I;I;I;I;0;0;0;0;0;0;0;0;0;0;0;0;0;0;0;0;0;0;0;0;0;0;0;0;0;0;0;0;0;0;0;0;0;0;0;0;0;0;0;0;0;0;0;0;0
I;I;I;I;I;I;I;I;I;I;I;I;I;I;I;I;I;I;I;I;I;I;I;I;I;I;I;I;I;I;I;I;I;I;0;0;0;0;0;0;0;0;0;0;0;0;0;0;0;0;0;0;0;0;0;0;0;0;0;0;0;0;0;0;0;0;0;0;0;0;0;0;0;0;0;0;0;0
I;I;I;I;I;I;I;I;I;I;I;I;I;I;I;I;I;I;I;I;I;I;I;I;I;I;I;I;I;I;I;I;I;I;0;0;0;0;0;0;0;0;0;0;0;0;0;0;0;0;0;0;0;0;0;0;0;0;Z;Z;Z;Z;Z;Z;Z;Z;Z;Z;0;0;0;0;0;Z;Z;Z;Z;Z
I;I;I;I;I;I;I;I;I;I;I;I;I;I;I;I;I;I;I;I;I;I;I;I;I;I;I;I;I;I;I;I;I;I;0;0;0;0;0;0;0;0;0;0;0;0;0;0;0;0;0;0;0;0;0;0;0;0;Z;Z;Z;Z;Z;Z;Z;Z;Z;Z;Z;Z;Z;Z;Z;Z;Z;Z;Z;Z
I;I;I;I;I;I;I;I;I;I;I;I;I;I;I;I;I;I;I;I;I;I;I;I;I;I;I;I;I;I;I;I;I;0;0;0;0;0;0;0;0;0;0;0;0;0;0;0;0;0;0;0;0;0;0;0;0;Z;Z;Z;Z;Z;Z;Z;Z;Z;Z;Z;Z;Z;Z;Z;Z;Z;Z;Z;Z;Z
I;I;I;I;I;I;I;I;I;I;I;I;I;I;I;I;I;I;I;I;I;I;I;I;I;I;I;I;I;I;I;I;I;0;0;0;0;0;0;0;0;0;0;0;0;0;0;0;0;0;0;0;0;0;0;0;0;Z;Z;Z;Z;Z;Z;Z;Z;Z;Z;Z;Z;Z;Z;Z;Z;Z;Z;Z;Z;Z
I;I;I;I;I;I;I;I;I;I;I;I;I;I;I;I;I;I;I;I;I;I;I;I;I;I;I;I;I;I;I;I;I;I;I;I;0;0;0;0;0;0;0;0;0;0;0;0;0;0;0;0;0;0;0;0;0;Z;Z;Z;Z;Z;Z;Z;Z;Z;Z;Z;Z;Z;Z;Z;Z;Z;Z;Z;Z;Z
I;I;I;I;I;I;I;I;I;I;I;I;I;I;I;I;I;I;I;I;I;I;I;I;I;I;I;I;I;I;I;I;I;I;I;I;I;0;0;0;0;I;I;I;I;I;I;I;0;0;0;0;0;0;0;0;0;Z;Z;Z;Z;Z;Z;Z;Z;Z;Z;Z;Z;Z;Z;Z;Z;Z;Z;Z;Z;Z
I;I;I;I;I;I;I;I;I;I;I;I;I;I;I;I;I;I;I;I;I;I;I;I;I;I;I;I;I;I;I;I;I;I;I;I;I;I;I;I;I;I;I;I;I;I;I;I;I;0;0;0;0;0;0;0;0;Z;Z;Z;Z;Z;Z;Z;Z;Z;Z;Z;Z;Z;Z;Z;Z;Z;Z;Z;Z;Z
I;I;I;I;I;I;I;I;I;I;I;I;I;I;I;I;I;I;I;I;I;I;I;I;I;I;I;I;I;I;I;I;I;I;I;I;I;I;I;I;I;I;I;I;I;I;I;I;I;0;0;0;0;0;0;0;0;0;0;Z;Z;Z;Z;Z;Z;Z;Z;Z;Z;Z;Z;Z;Z;Z;Z;Z;Z;Z
I;I;I;I;I;I;I;I;I;I;I;I;I;I;I;I;I;I;I;I;I;I;I;I;I;I;I;I;I;I;I;I;I;I;I;I;I;I;I;I;I;I;I;I;I;I;I;I;I;I;0;0;0;0;0;0;0;0;0;Z;Z;Z;Z;Z;Z;Z;Z;Z;Z;Z;Z;Z;Z;Z;Z;Z;Z;Z
I;I;I;I;I;I;I;I;I;I;I;I;I;I;I;I;I;I;I;I;I;I;I;I;I;I;I;I;I;I;I;I;I;I;I;I;I;I;I;I;I;I;I;I;I;I;I;I;I;I;0;0;0;0;0;0;0;0;0;0;0;0;Z;Z;Z;Z;Z;Z;Z;Z;Z;Z;Z;Z;Z;Z;Z;Z
I;I;I;I;I;I;I;I;I;I;I;I;I;I;I;I;I;I;I;I;I;I;I;I;I;I;I;I;I;I;I;I;I;I;I;I;I;I;I;I;I;I;I;I;I;I;I;I;I;I;0;0;0;I;I;I;I;0;0;0;0;0;0;Z;Z;Z;Z;Z;Z;Z;Z;Z;Z;Z;Z;Z;0;0
I;I;I;I;I;I;I;I;I;I;I;I;I;I;I;I;I;I;I;I;I;I;I;I;I;I;I;I;I;I;I;I;I;I;I;I;I;I;I;I;I;I;I;I;I;I;I;I;I;I;I;I;I;I;I;I;I;0;0;0;0;0;0;0;Z;Z;Z;Z;Z;Z;Z;Z;Z;Z;Z;Z;0;0
I;I;I;I;I;I;I;I;I;I;I;I;I;I;I;I;I;I;I;I;I;I;I;I;I;I;I;I;I;I;I;I;I;I;I;I;I;I;I;I;I;I;I;I;I;I;I;I;I;I;I;I;I;I;I;I;I;0;0;0;0;0;0;0;0;Z;Z;Z;Z;Z;Z;Z;Z;Z;Z;0;0;0
I;I;I;I;I;I;I;I;I;I;I;I;I;I;I;I;I;I;I;I;I;I;I;I;I;I;I;I;I;I;I;I;I;I;I;I;I;I;I;I;I;I;I;I;I;I;I;I;I;I;I;I;I;I;I;I;I;0;0;0;0;0;0;0;0;0;Z;Z;Z;Z;Z;Z;Z;Z;0;0;0;0
