1 1 1 1 1 1 1 1 1 1 1 1 1 1 1 1 1 1 1 1 1 1 1 1 1 1 1 1 1 1 1 1 1 1 1 1 1 1 1 1 1 1 1 1 1 1 1 1 1 1 1 1 1 1 1 1 1 1 1 1 1 1 1 1 1 1 1 1 1 1 1 1 1 1 1 1 1 1 1 1
1 0 0 0 0 0 0 0 0 0 0 0 0 0 0 0 0 0 0 0 0 0 0 0 0 0 0 0 0 0 0 0 0 0 0 0 0 0 0 0 0 0 0 0 0 0 0 0 0 0 0 0 0 0 0 0 0 0 0 0 0 0 0 0 0 0 0 0 0 0 0 0 0 0 0 0 0 0 0 1
1 0 0 0 0 0 0 0 0 0 0 0 0 0 0 0 0 0 0 0 0 0 0 0 0 0 0 0 0 0 0 0 0 0 0 0 0 0 0 0 0 0 0 0 0 0 0 0 0 0 0 0 0 0 0 0 0 0 0 0 0 0 0 0 0 0 0 0 0 0 0 0 0 0 0 0 0 0 0 1
1 0 0 0 0 0 0 C 0 0 0 0 0 0 0 0 0 0 0 0 0 1 0 0 0 0 0 0 0 0 0 0 0 0 0 0 0 0 0 0 0 0 0 0 0 0 0 0 0 0 0 0 0 0 0 0 0 0 0 0 1 1 1 1 0 0 0 0 0 0 0 0 0 0 0 0 0 0 0 1
1 0 0 0 0 0 0 0 0 0 0 0 0 0 0 0 0 0 0 0 0 0 0 0 0 0 0 0 0 0 0 0 0 0 0 0 0 0 0 0 0 0 0 0 0 0 0 0 0 0 0 0 0 0 0 0 < 1 1 1 1 1 1 1 0 0 0 0 0 0 0 0 0 0 0 0 0 0 0 1
1 0 0 0 0 0 0 1 1 1 1 1 1 1 1 1 1 1 1 0 0 0 0 0 0 0 0 ^ ^ ^ ^ ^ ^ ^ ^ ^ ^ 0 0 0 0 0 0 0 0 0 0 0 0 0 0 0 0 0 0 0 < 1 1 1 1 1 1 1 0 0 0 0 0 0 0 0 0 0 0 0 0 0 0 0
0 0 0 0 0 0 0 1 1 1 1 1 1 1 1 1 1 1 1 0 0 0 0 0 0 0 0 0 0 0 0 0 0 0 0 0 > 0 0 0 0 0 0 0 0 0 0 0 0 0 0 0 0 0 0 0 < 1 1 1 1 1 1 1 0 0 0 0 0 0 0 0 0 0 0 0 0 0 0 0
0 0 0 0 _ _ ^ 1 1 1 1 1 1 1 0 0 D D D 0 0 0 0 0 0 0 0 0 0 0 0 0 0 0 0 0 > 0 0 0 0 0 0 0 0 0 0 0 0 0 0 0 0 0 0 0 < 1 1 1 1 1 1 1 0 0 0 0 0 0 0 0 0 0 0 0 ^ ^ ^ 0
0 0 0 0 0 0 1 1 1 1 1 1 1 1 0 0 D D D 0 0 0 0 0 0 0 0 0 0 0 0 0 0 0 0 0 > 0 0 0 0 0 0 0 0 0 0 0 0 0 1 0 0 0 0 0 < 1 1 1 1 1 1 1 0 0 0 0 0 0 0 0 0 0 0 0 0 0 0 0
0 0 P 0 0 0 1 1 1 1 D D D D 0 0 D D D 0 0 0 0 0 0 0 0 0 0 0 0 0 0 0 0 0 > 0 0 0 0 0 0 0 0 0 0 0 0 0 1 0 0 0 0 0 < 1 1 1 1 1 1 1 0 0 0 0 0 0 0 0 0 0 0 0 0 P 0 0
0 0 0 0 0 0 1 1 1 0 D D D D 0 0 D D D 0 0 0 0 0 0 0 0 0 0 0 0 0 0 0 0 0 > 0 0 0 0 0 0 0 0 0 0 0 0 0 1 0 0 0 0 0 < v v v v v v v 0 0 < 1 1 1 1 1 1 1 0 0 0 0 0 0
1 0 0 0 0 0 D D D 0 D D D D 0 0 D D D 0 0 0 0 0 0 1 1 1 1 1 1 1 1 1 1 0 0 0 0 0 0 0 0 0 0 0 0 0 0 0 1 0 0 0 0 0 0 0 0 0 0 0 0 0 0 0 < 1 1 1 1 1 1 1 0 0 1 1 1 1
1 0 0 0 0 0 1 1 0 0 D D D D 0 0 D D D 0 0 0 0 0 0 1 1 > 0 1 1 1 1 1 1 1 1 1 1 1 1 1 ^ ^ ^ ^ ^ ^ ^ ^ 1 0 1 1 1 0 0 0 0 0 0 0 0 0 0 0 < 1 1 1 1 1 1 1 ^ ^ 1 1 1 1
1 0 0 0 0 < 1 1 0 0 D D D D 0 0 D D D ^ ^ ^ 0 0 0 1 D > 0 D D D D D D D 0 1 1 1 1 1 1 1 1 1 1 1 1 1 1 0 1 1 1 0 0 0 0 0 0 0 0 0 0 0 < 1 1 1 1 1 1 1 1 1 1 1 1 1
1 0 0 0 0 < 1 1 0 0 D D D D 0 0 D D D 1 1 1 0 0 0 1 0 0 0 D D D D D D D 0 0 0 0 1 1 1 1 1 0 1 1 1 1 1 0 0 1 1 0 0 1 1 1 0 0 0 0 0 0 < 1 1 1 1 1 1 1 1 1 1 1 1 1
1 0 0 0 ^ ^ 1 1 0 0 D D D D 0 0 0 0 0 1 1 1 0 0 0 0 0 0 0 D D D D D D D 0 0 0 0 1 1 1 1 1 0 1 1 1 1 1 _ _ 1 0 0 0 1 1 1 0 0 0 0 0 0 1 1 1 1 1 1 1 1 1 1 1 1 1 1
1 0 0 0 D D D D D 0 D D D D 0 0 0 0 0 D D D 0 0 0 0 0 0 0 D D D D D D D 0 0 0 0 < 1 1 1 1 0 1 1 1 1 1 0 0 1 0 0 0 D D D D 0 0 0 0 0 1 1 1 1 1 1 1 1 1 1 1 1 1 1
1 0 0 0 D D D D D 0 D D D D 0 0 0 0 0 D D D 0 0 0 0 0 0 0 D D D D D D D 0 0 0 0 < 1 1 1 1 0 1 1 1 1 1 0 0 1 0 0 0 D D D D 0 0 0 0 0 0 0 0 0 0 0 0 0 1 1 1 1 1 1
1 0 0 0 D D D D D 0 D D D D 0 0 0 D 0 D D D 0 0 0 0 0 0 0 D D D D D D D 0 0 0 0 < 1 1 1 1 0 1 1 1 1 1 0 0 0 0 0 0 D D D D 0 0 0 0 0 0 0 0 0 0 0 0 0 1 1 1 1 1 1
1 0 0 0 D D D D D 0 D D D D 0 0 0 D 0 0 0 1 0 0 0 0 0 0 0 D D D D D D D 0 0 0 0 < 1 1 1 1 0 1 1 1 1 0 0 0 0 0 0 0 D D D D 0 0 0 0 0 0 0 0 0 0 0 0 0 1 1 1 1 1 1
1 0 0 0 D D D D D 0 D D D D 0 0 0 D 0 0 0 1 1 0 0 0 0 0 0 1 1 1 1 1 1 1 0 0 0 0 < 1 1 1 1 0 1 1 1 1 0 0 0 0 0 0 0 D D D D 0 0 0 0 0 0 0 0 0 0 0 0 0 1 1 1 1 1 1
1 0 0 0 D D D D D 0 0 1 1 1 1 1 1 D 0 0 0 1 1 0 0 0 0 0 0 0 0 0 0 0 D D 0 0 0 0 < 1 1 1 1 0 1 1 1 1 0 0 0 0 0 0 0 D D D D 0 0 0 0 0 0 0 0 0 0 0 0 0 1 1 1 1 1 0
1 0 0 0 D D D D D 0 0 1 1 1 1 1 1 D 0 0 0 1 1 0 0 0 0 0 0 0 0 0 0 0 D D 0 0 0 0 0 < 1 1 1 1 1 0 0 0 0 0 0 0 0 0 0 D D D D 0 0 0 0 0 0 0 0 0 0 0 0 0 1 0 1 1 1 ^
1 0 0 ^ 1 1 1 1 0 0 0 1 1 1 0 0 D 1 1 1 1 1 1 0 0 0 0 0 0 0 0 0 0 0 D D 0 0 0 0 0 < 1 1 1 1 1 0 0 0 0 0 0 0 0 0 0 D D D D 0 0 0 0 0 0 0 0 1 1 1 1 0 0 0 1 1 1 1
1 0 0 1 1 1 1 1 0 0 0 1 1 1 0 0 D 1 1 1 1 1 1 0 0 0 0 0 0 0 0 0 0 0 D D 0 0 0 0 0 < 1 1 1 1 1 0 0 0 0 0 0 0 0 0 0 D D D D 0 0 0 0 0 0 0 0 1 1 1 1 0 0 0 1 1 1 1
1 0 0 1 1 1 1 1 0 0 0 0 0 0 0 0 D 1 1 1 1 1 1 0 0 0 0 0 0 0 0 0 0 0 D D 0 0 0 0 ^ ^ 1 1 1 0 0 0 0 0 0 0 0 0 0 0 0 D D D D 0 0 0 0 0 0 0 0 1 1 1 1 0 0 0 0 1 1 1
1 0 0 0 0 0 1 1 0 0 0 0 0 0 0 0 D 1 1 1 1 1 1 0 0 0 0 0 0 0 0 0 0 0 D D 0 0 0 0 D D D D D 0 0 0 0 0 0 0 0 0 0 0 0 0 v v 0 0 0 0 0 ^ 0 0 0 1 1 1 1 0 0 0 0 1 1 1
1 0 0 0 0 0 0 0 0 0 0 0 0 0 0 0 D 1 1 1 1 1 1 0 0 0 0 0 0 0 0 0 0 0 D D 0 0 0 0 D D D D D 0 0 0 0 0 0 0 0 0 0 0 0 0 0 0 0 0 0 0 0 D 0 0 0 1 1 1 1 0 0 0 0 0 0 0
1 0 0 0 0 0 0 0 0 0 0 0 0 0 0 0 D 1 1 1 1 1 1 0 D 1 0 0 0 0 0 0 0 0 D D 0 0 0 0 D D D D D 0 0 0 0 0 0 0 0 0 0 0 0 0 0 0 0 0 0 0 0 D 0 0 0 1 1 1 1 0 0 0 0 0 0 0
1 0 0 0 0 0 0 0 0 0 0 0 0 0 0 0 D 1 1 1 1 1 1 0 D 1 0 0 0 0 0 0 0 0 D D ^ ^ ^ 0 0 0 0 0 1 1 1 1 1 1 1 1 1 1 1 1 0 0 0 1 1 1 1 1 1 1 0 0 0 0 D D D 0 0 0 0 0 0 0
1 0 0 0 0 0 0 0 0 0 0 0 0 0 0 0 0 1 1 1 1 1 1 0 D 0 0 0 0 0 0 0 0 0 D D 1 1 1 ^ ^ ^ ^ ^ 1 1 1 1 1 1 1 1 1 1 1 1 _ 0 0 1 1 0 0 0 0 0 0 0 0 0 D D D 0 0 0 0 0 0 0
1 0 0 0 0 0 0 0 0 0 0 0 0 0 0 0 0 1 0 0 0 0 0 0 D 0 0 0 0 0 0 0 0 0 D D 1 1 1 1 1 1 1 1 1 1 1 1 1 1 1 1 1 1 1 1 0 0 0 1 1 0 0 0 0 0 0 0 0 0 D D D 0 0 0 0 0 0 0
1 0 0 0 0 0 0 0 0 0 0 0 0 0 0 0 0 1 0 0 0 0 0 0 D ^ ^ ^ ^ ^ ^ ^ ^ 0 D D 0 1 1 1 1 1 1 1 1 1 1 1 1 1 1 1 1 1 1 1 0 0 0 1 1 0 0 0 0 0 0 0 0 0 D D D ^ ^ ^ ^ ^ ^ ^
1 0 0 0 0 0 0 0 0 0 0 0 0 0 0 0 0 1 0 0 0 0 0 0 D 1 1 1 1 1 1 1 1 0 D D 0 0 0 0 0 0 0 0 1 1 1 1 1 1 0 0 0 0 0 0 0 0 0 1 1 0 0 0 0 0 0 0 0 0 D D D 1 1 1 1 1 1 1
1 0 0 0 0 0 0 0 0 0 0 0 0 0 0 0 0 0 0 0 0 0 0 0 D 1 1 1 1 1 1 1 1 1 D D 0 0 0 0 0 0 0 0 1 1 1 1 1 1 0 0 0 0 0 0 0 0 0 1 1 0 0 0 0 0 0 0 0 0 D D D 1 1 1 1 1 1 1
1 0 0 0 0 0 0 0 0 0 0 0 0 0 0 0 0 0 0 1 1 1 1 1 1 1 1 1 1 1 1 1 1 1 D D 0 0 0 0 0 0 0 0 1 1 1 1 1 0 0 0 0 0 0 0 0 0 0 1 1 1 1 1 1 0 0 0 0 0 D D D 1 1 1 1 1 1 1
1 0 0 0 0 0 0 0 0 0 0 0 0 0 0 0 0 0 0 0 1 1 1 1 1 1 1 1 1 1 1 1 1 1 D D 0 0 0 0 0 0 0 0 0 0 0 0 0 0 0 0 0 0 0 0 0 0 0 1 1 1 1 1 1 0 0 0 0 0 D D D 1 1 1 1 1 1 1
1 0 0 0 0 0 0 0 0 0 0 0 0 0 0 0 0 0 0 0 1 1 1 1 1 1 1 1 0 0 0 0 0 0 D D 0 0 0 0 0 0 0 0 0 0 0 0 0 0 0 0 0 0 0 0 0 0 0 0 0 0 0 0 0 0 0 0 0 0 D D D 0 0 1 1 1 1 1
1 0 0 0 0 0 0 0 0 0 0 0 0 0 0 0 0 0 0 0 1 1 1 1 1 1 1 1 0 0 0 0 0 0 D D 0 0 0 0 0 0 0 0 0 0 0 0 0 0 0 0 0 0 0 0 0 0 0 0 0 0 0 0 0 0 0 0 0 0 D D D 0 0 0 1 1 1 1
1 0 0 0 0 0 0 0 0 0 0 0 0 0 0 0 0 0 0 0 1 1 1 1 1 1 1 1 0 0 0 0 0 0 D D 0 0 0 0 0 0 0 0 0 0 0 0 0 0 0 0 0 0 0 0 0 0 0 0 0 0 0 0 0 0 0 0 0 0 D D D 0 0 0 1 1 1 1
1 0 0 0 0 0 0 0 0 0 0 0 0 0 0 0 0 0 0 0 1 0 0 1 1 1 1 1 1 1 1 1 1 1 1 1 0 0 0 0 0 0 0 0 0 0 0 0 0 0 0 0 0 0 0 0 0 0 0 0 0 0 0 0 0 0 0 0 0 0 D D D 0 0 0 1 1 1 1
1 0 0 0 0 0 0 0 0 0 0 0 0 0 0 0 0 0 0 0 1 0 0 1 1 1 1 1 1 1 1 1 1 1 1 1 0 0 0 0 0 0 0 0 0 0 0 0 0 0 0 0 0 0 0 0 0 0 0 0 0 0 0 0 0 0 0 0 0 0 0 0 1 0 0 0 1 1 1 0
1 0 0 0 0 0 0 0 0 0 0 0 0 0 0 0 0 0 0 0 1 0 0 1 1 1 1 1 1 1 0 0 0 1 1 1 0 0 0 0 0 0 0 0 0 0 0 0 0 0 0 ^ ^ ^ ^ ^ ^ ^ ^ ^ 0 0 0 0 0 0 0 0 0 0 0 0 0 0 0 0 1 1 1 0
1 0 0 0 0 0 0 0 0 0 0 0 0 0 0 0 0 0 0 0 0 0 0 1 1 0 0 0 1 1 0 0 0 1 1 1 0 0 0 0 0 0 0 0 0 0 0 0 0 0 0 1 1 1 1 1 1 1 1 1 0 0 0 0 0 0 0 0 0 0 0 0 0 0 0 0 1 1 1 0
1 0 0 0 0 0 0 0 0 0 0 0 0 0 0 0 0 0 0 0 0 0 0 1 1 0 0 0 1 1 0 0 0 1 1 1 1 1 1 1 1 1 1 1 1 ^ ^ ^ ^ ^ ^ 1 1 1 1 1 1 1 1 1 0 0 0 0 0 0 0 0 0 0 0 0 0 0 0 0 1 1 1 0
1 1 1 1 1 1 0 0 0 0 0 0 0 0 0 1 1 1 0 0 R 0 0 1 1 0 0 0 1 1 0 0 0 1 1 1 1 0 0 0 0 0 0 0 1 1 1 1 1 1 1 1 1 1 1 1 1 1 1 1 0 0 0 0 0 0 0 0 0 0 0 0 0 0 0 0 1 1 1 0
