0;0;0;0;0;0;0;0;0;0;0;0;0;W;L;L;L;L;L;L;L;L
0;0;0;0;0;0;0;0;0;0;0;0;0;W;L;L;L;L;L;L;L;L
W;W;W;W;W;W;W;W;W;W;W;W;W;W;L;L;L;L;L;L;L;L
L;L;L;L;L;L;L;L;L;L;L;L;L;L;L;L;L;L;L;L;L;L
L;L;L;L;L;L;L;L;L;L;L;L;L;L;L;L;L;L;L;L;L;L
L;L;L;L;L;L;L;L;L;L;L;L;L;L;L;L;L;L;L;L;L;L
L;L;L;L;L;L;L;L;L;L;L;L;L;L;L;L;L;L;L;L;L;L
L;L;L;L;L;L;L;L;L;L;L;L;L;L;L;L;L;L;L;L;L;L
L;L;L;L;L;L;L;L;L;L;L;L;L;L;L;L;W;W;W;W;W;W
L;L;L;L;L;L;L;L;L;L;L;L;L;L;L;L;W;0;0;0;0;0
L;L;L;L;L;L;W;W;W;W;W;W;W;W;W;W;W;0;0;0;0;0
L;L;L;L;L;L;W;0;0;0;0;0;0;0;0;0;0;0;0;0;0;0
L;L;L;L;L;L;W;0;0;0;0;0;0;0;0;0;0;0;0;0;0;0
