o;o;0;0;0;0;0;0;0;0;0
o;o;0;0;0;0;0;0;0;0;0
o;o;0;0;0;0;0;0;0;0;0
0;0;0;0;0;0;0;0;0;0;0
0;0;0;0;0;0;0;0;0;0;0
0;0;0;0;0;0;0;0;0;0;0
0;0;0;0;0;0;0;0;0;0;0
0;0;0;0;0;0;0;0;0;0;0
0;0;0;0;0;0;0;0;0;0;0
0;0;0;0;0;0;0;0;0;0;0
0;0;0;0;0;0;0;0;0;0;0
0;0;0;0;0;0;0;0;0;0;0
0;0;0;0;0;0;0;0;0;0;0
0;0;0;0;0;0;0;0;0;0;0
o;o;0;0;0;0;0;0;0;0;0
o;o;n;n;0;0;0;0;0;0;0
n;n;n;n;0;0;0;0;0;0;0
n;n;n;n;0;0;0;0;0;0;0
n;o;n;n;0;0;0;0;0;0;0
n;o;n;n;0;0;0;0;0;0;0
