T;T;T;T;T;T;T;7;7;1;1;0;0;0;0;0;0;0;0
T;T;T;T;T;T;T;7;7;1;P;0;0;0;0;0;0;0;0
T;T;T;T;T;T;T;7;7;1;P;0;0;0;0;0;0;0;0
T;T;T;T;7;7;7;7;7;7;P;P;4;4;0;0;0;0;0
7;P;7;7;7;7;7;7;7;7;P;0;0;0;0;0;0;0;0
7;P;P;P;P;7;7;7;7;7;P;4;0;0;0;0;0;0;0
P;P;7;7;7;7;7;7;7;7;P;0;0;0;0;0;0;0;0
7;P;7;7;7;7;7;7;7;7;P;P;P;P;P;7;7;7;P
7;P;7;7;7;7;7;7;7;7;7;P;7;7;P;7;7;7;P
7;P;7;7;7;7;7;7;7;7;7;P;7;7;P;7;7;7;P
