A;A;A;A;A;A;A;A;A;A;A;A;A;A;A;A;A;A;A;A;A;A;0;0;0;0;0;0;0;0;0;0;0;0;0;0;0;0;0;0
A;A;A;A;A;A;A;A;A;A;A;A;A;A;A;A;A;A;A;A;A;A;0;0;0;0;0;0;0;0;0;0;0;0;0;0;0;0;0;0
A;A;A;A;A;A;A;A;A;A;A;A;A;A;A;A;A;A;A;A;A;A;0;0;0;0;0;0;0;0;0;0;0;0;0;0;0;0;0;0
A;A;A;A;A;A;A;A;A;A;A;A;A;A;A;A;A;A;A;A;A;A;0;0;0;0;0;0;0;0;0;0;0;0;0;0;0;0;0;0
A;A;A;A;A;A;A;A;A;A;A;A;A;A;A;A;A;A;A;A;A;A;0;0;0;0;0;0;0;0;0;0;0;0;0;0;0;0;0;0
A;A;A;A;A;A;A;A;A;A;A;A;A;A;A;A;A;A;A;A;A;A;0;0;0;0;0;0;0;0;0;0;0;0;0;0;0;0;0;0
A;A;A;A;A;A;A;A;A;A;A;A;A;A;A;A;A;A;A;A;A;A;0;0;0;0;0;0;0;0;0;0;0;0;0;0;0;0;0;0
A;A;A;A;A;A;A;A;A;A;A;A;A;A;A;A;A;A;A;A;A;A;0;0;0;0;0;0;0;0;0;0;0;0;0;0;0;0;0;0
A;A;A;A;A;A;A;A;A;A;A;A;A;A;A;A;A;A;A;A;A;A;0;0;0;0;0;0;0;0;0;0;0;0;0;0;0;0;0;0
A;A;A;A;A;A;A;A;A;A;A;A;A;A;A;A;A;A;A;A;A;0;0;0;0;0;0;0;0;0;0;0;0;0;0;0;0;0;0;0
A;A;A;A;A;A;A;A;A;A;A;A;A;A;A;A;A;A;A;A;A;0;0;0;0;0;0;0;0;0;0;0;0;0;0;0;0;0;0;0
A;A;A;A;A;A;A;A;A;A;A;A;A;A;A;A;A;A;A;A;A;0;0;0;0;0;0;0;0;0;0;0;0;0;0;0;0;0;0;0
A;A;A;A;A;A;A;A;A;A;A;A;A;A;A;A;A;A;A;A;A;0;0;0;0;0;0;0;0;0;0;0;0;0;0;0;0;0;0;0
A;A;A;A;A;A;A;A;A;A;A;A;A;A;A;A;A;A;A;A;A;0;0;0;0;0;0;0;0;0;0;0;0;0;0;0;0;0;0;0
A;A;A;A;A;A;A;A;A;A;A;A;A;A;A;A;A;A;A;A;A;0;0;0;0;0;0;0;0;0;0;0;0;0;0;0;0;0;0;0
A;A;A;A;A;A;A;A;A;A;A;A;A;A;A;A;A;A;A;A;A;0;0;0;0;0;0;0;0;0;0;0;0;0;0;0;0;0;0;0
A;A;A;A;A;A;A;A;A;A;A;A;A;A;A;A;A;A;A;A;A;0;0;0;0;0;0;0;0;0;0;0;0;0;0;0;0;0;0;0
A;A;A;A;A;A;A;A;A;A;A;A;A;A;A;A;A;A;A;A;A;0;0;0;0;0;0;0;0;0;0;0;0;0;0;0;0;0;0;0
A;A;A;A;A;A;A;A;A;A;A;A;A;A;A;A;A;A;A;A;A;0;0;0;0;0;0;0;0;0;0;0;0;0;0;0;0;0;0;0
A;A;A;A;A;A;A;A;A;A;A;A;A;A;A;A;A;A;A;A;A;0;0;0;0;0;0;0;0;0;0;0;0;0;0;0;0;0;0;0
A;A;A;A;A;A;A;A;A;A;A;A;A;A;A;A;A;A;A;A;0;0;0;0;0;0;0;0;0;0;0;0;0;0;0;0;0;0;0;0
A;A;A;A;A;A;A;A;A;A;A;A;A;A;A;A;A;A;A;A;0;0;0;0;0;0;0;0;0;0;0;0;0;0;0;0;0;0;0;0
A;A;A;A;A;A;A;A;A;A;A;A;A;A;A;A;A;A;A;A;0;0;0;0;0;0;0;0;0;0;0;0;0;0;0;0;0;0;0;0
