c;c;c;c;c;c;c;c;c;c;c;c;c;c;c;c;c;c;c;c;c;c;c;c;c;c;c;c;c;c;c;c;c;c;c;0;0;c;c;c
c;c;c;c;c;c;c;c;c;c;c;c;c;c;c;c;c;c;c;c;c;c;c;c;c;c;c;c;c;c;c;c;c;c;c;0;0;c;c;c
c;c;0;0;0;0;0;0;0;0;0;0;0;0;0;0;0;0;0;0;0;0;0;0;0;0;0;0;0;0;0;0;0;0;0;0;0;0;c;c
c;c;0;0;0;0;0;0;0;0;0;0;0;0;0;0;0;0;0;0;0;0;0;0;0;0;0;0;0;0;0;0;0;0;0;0;0;0;c;c
c;c;0;0;0;0;0;0;0;0;0;0;0;0;0;0;0;0;0;0;0;0;0;0;0;0;0;0;0;0;0;0;0;0;0;0;0;0;c;c
c;c;0;0;0;0;0;0;0;0;0;0;0;0;0;0;0;0;0;0;0;0;0;0;0;0;0;0;0;0;0;0;0;0;0;0;0;0;c;c
c;c;0;0;0;0;0;0;0;0;0;0;0;0;0;0;0;0;0;0;0;0;0;0;0;0;0;0;0;0;0;0;0;0;0;c;c;c;c;c
c;c;0;0;0;0;0;0;0;0;0;0;0;0;0;0;0;0;0;0;0;0;0;0;0;0;0;0;0;0;0;0;0;0;0;c;c;c;c;c
c;c;0;0;0;0;0;0;0;0;0;0;0;0;0;0;0;0;0;0;0;0;0;0;0;0;0;0;0;0;0;0;0;0;0;c;c;c;c;c
c;c;0;0;0;0;0;0;0;0;0;0;0;0;0;0;0;0;0;0;0;0;0;0;0;0;0;0;0;0;0;0;0;0;0;0;0;0;c;c
c;c;0;0;0;0;0;0;0;0;0;0;0;0;0;0;0;0;0;0;0;0;0;0;0;0;0;0;0;0;0;0;0;0;0;0;0;0;c;c
c;c;0;0;0;0;0;c;c;c;c;c;c;0;0;0;0;0;0;0;0;0;0;0;0;0;0;c;c;c;c;c;c;0;0;0;0;0;c;c
0;0;0;0;0;0;0;c;c;c;c;c;c;0;0;0;0;c;c;c;c;c;c;0;0;0;0;c;c;c;c;c;c;0;0;0;0;0;c;c
0;0;0;0;0;0;0;c;c;0;0;c;c;c;c;c;c;c;c;c;c;c;c;c;c;c;c;c;c;0;0;c;c;0;0;0;0;0;c;c
0;0;0;0;0;0;0;c;c;0;0;c;c;c;c;c;c;c;c;c;c;c;c;c;c;c;c;c;c;0;0;c;c;0;0;0;0;0;c;c
c;c;0;0;0;0;0;c;c;0;0;c;c;0;0;0;0;0;0;c;c;0;0;0;0;0;0;c;c;0;0;c;c;0;0;0;0;0;c;c
c;c;0;0;0;0;0;c;c;0;0;c;c;0;0;0;0;0;0;c;c;0;0;0;0;0;0;c;c;0;0;c;c;0;0;0;0;0;c;c
c;c;c;c;c;c;c;c;c;0;0;c;c;c;c;c;c;c;c;c;c;c;c;c;c;c;c;c;c;0;0;c;c;c;c;c;c;c;c;c
c;c;c;c;c;c;c;c;c;0;0;c;c;c;c;c;c;c;c;c;c;c;c;c;c;c;c;c;c;0;0;c;c;c;c;c;c;c;c;c
c;c;c;c;c;c;c;c;c;0;0;c;c;0;0;0;0;0;0;c;c;0;0;0;0;0;0;c;c;0;0;c;c;c;c;c;c;c;c;c
c;c;c;c;c;c;c;c;c;0;0;c;c;0;0;0;0;0;0;c;c;0;0;0;0;0;0;c;c;0;0;c;c;c;c;c;c;c;c;c
c;c;c;c;c;c;c;c;c;c;c;c;c;c;c;c;c;c;c;c;c;c;c;c;c;c;c;c;c;c;c;c;c;c;c;c;c;c;c;c
c;c;c;c;c;c;c;c;c;c;c;c;c;c;c;c;c;c;c;c;c;c;c;c;c;c;c;c;c;c;c;c;c;c;c;c;c;c;c;c
