0;0;0;0;0;0;0;0;0;0;0;0;0;0;0;0;0;X;X;X;X;X;X;X;X;X;X;X;X;X;X;X;X;X;X;X;X;X;X;X;X;X;0;0;0;0;0;0;0;X;X;X;X;X;X;X;0;0;0;0;0;0;0;0;0;0;0;0;0;0;0;0;0;0;0;0;0;0;0;0;0;0;X;X;X;X;X;X;X;0;0;0;0;0;0;0;0;0;0;0;0;X;X;X;X;X;0;0;0;0;0;0;0;0;0;0;0;0;0;0;0;0;0;0;X;X;X;X;X;X;0;0;0;0;0;0;0;0;0;0;0;0;0;0;0;0;0;0;0;0;0;0;0;0;0;0;0;0;0;0;0;0;0;0;0;0;0;0;0;0;0;0;0;0;0;0;0;0;X;X;X;X;X;X;X;X;X;X;X;X;0;0;0;0;0;0;0;0;X;X;X;X;X;X;X;0;0;0;0;0;0;0;0;0;0;0;0;0;0;0
0;0;0;0;0;0;0;0;0;0;0;0;0;0;0;0;0;X;X;X;X;X;X;X;X;X;X;X;X;X;X;X;X;X;X;X;X;X;X;X;X;X;0;0;0;0;0;0;0;X;X;X;X;X;X;X;0;0;0;0;0;0;0;0;0;0;0;0;0;0;0;0;0;0;0;0;0;0;0;0;0;0;X;X;X;X;X;X;X;0;0;0;0;0;0;0;0;0;0;0;0;X;X;X;X;X;0;0;0;0;0;0;0;0;0;0;0;0;0;0;0;0;0;0;X;X;X;X;X;X;0;0;0;0;0;0;0;0;0;0;0;0;0;0;0;0;0;0;0;0;0;0;0;0;0;0;0;0;0;0;0;0;0;0;0;0;0;0;0;0;0;0;0;0;0;0;0;0;X;X;X;X;X;X;X;X;X;X;X;X;0;0;0;0;0;0;0;0;X;X;X;X;X;X;X;0;0;0;0;0;0;0;0;0;0;0;0;0;0;0
0;0;0;0;0;0;0;0;0;0;0;0;0;0;0;0;0;X;X;X;X;X;X;X;X;X;X;X;X;X;X;X;X;X;X;X;X;X;X;X;X;X;0;0;0;0;0;0;0;X;X;X;X;X;X;X;0;0;0;0;0;0;0;0;0;0;0;0;0;0;0;0;0;0;0;0;0;0;0;0;0;0;X;X;X;X;X;X;X;0;0;0;0;0;0;0;0;0;0;0;0;X;X;X;X;X;0;0;0;0;0;0;0;0;0;0;0;0;0;0;0;0;0;0;X;X;X;X;X;X;0;0;0;0;0;0;0;0;0;0;0;0;0;0;0;0;0;0;0;0;0;0;0;0;0;0;0;0;0;0;0;0;0;0;0;0;0;0;0;0;0;0;0;0;0;0;0;0;X;X;X;X;X;X;X;X;X;X;X;X;0;0;0;0;0;0;0;0;X;X;X;X;X;X;X;0;0;0;0;0;0;0;0;0;0;0;0;0;0;0
0;0;0;0;0;0;0;0;0;0;0;0;0;0;0;0;0;X;X;X;X;X;X;X;X;X;X;X;X;X;X;X;X;X;X;X;X;X;X;X;X;X;0;0;0;0;0;0;0;X;X;X;X;X;X;X;0;0;0;0;0;0;0;0;0;0;0;0;0;0;0;0;0;0;0;0;0;0;0;0;0;0;X;X;X;X;X;X;X;0;0;0;0;0;0;0;0;0;0;0;0;X;X;X;X;X;0;0;0;0;0;0;0;0;0;0;0;0;0;0;0;0;0;0;X;X;X;X;X;X;0;0;0;0;0;0;0;0;0;0;0;0;0;0;0;0;0;0;0;0;0;0;0;0;0;0;0;0;0;0;0;0;0;0;0;0;0;0;0;0;0;0;0;0;0;0;0;0;X;X;X;X;X;X;X;X;X;X;X;X;0;0;0;0;0;0;0;0;X;X;X;X;X;X;X;0;0;0;0;0;0;0;0;0;0;0;0;0;0;0
0;0;0;0;0;0;0;0;0;0;0;0;0;0;0;0;0;X;X;X;X;X;X;X;X;X;X;X;X;X;X;X;X;X;X;X;X;X;X;X;X;X;0;0;0;0;0;0;0;X;X;X;X;X;X;X;0;0;0;0;0;0;0;0;0;0;0;0;0;0;0;0;0;0;0;0;0;0;0;0;0;0;X;X;X;X;X;X;X;0;0;0;0;0;0;0;0;0;0;0;0;X;X;X;X;X;0;0;0;0;0;0;0;0;0;0;0;0;0;0;0;0;0;0;X;X;X;X;X;X;0;0;0;0;0;0;0;0;0;0;0;0;0;0;0;0;0;0;0;0;0;0;0;0;0;0;0;0;0;0;0;0;0;0;0;0;0;0;0;0;0;0;0;0;0;0;0;0;X;X;X;X;X;X;X;X;X;X;X;X;0;0;0;0;0;0;0;0;X;X;X;X;X;X;X;0;0;0;0;0;0;0;0;0;0;0;0;0;0;0
0;0;0;0;0;0;0;0;0;0;0;0;0;0;0;0;0;X;X;X;X;X;X;X;X;X;X;X;X;X;X;X;X;X;X;X;X;X;X;X;X;X;0;0;0;0;0;0;0;X;X;X;X;X;X;X;0;0;0;0;0;0;0;0;0;0;0;0;0;0;0;0;0;0;0;0;0;0;0;0;0;0;X;X;X;X;X;X;X;0;0;0;0;0;0;0;0;0;0;0;0;X;X;X;X;X;0;0;0;0;0;0;0;0;0;0;0;0;0;0;0;0;0;0;X;X;X;X;X;X;0;0;0;0;0;0;0;0;0;0;0;0;0;0;0;0;0;0;0;0;0;0;0;0;0;0;0;0;0;0;0;0;0;0;0;0;0;0;0;0;0;0;0;0;0;0;0;0;X;X;X;X;X;X;X;X;X;X;X;X;0;0;0;0;0;0;0;0;X;X;X;X;X;X;X;0;0;0;0;0;0;0;0;0;0;0;0;0;0;0
0;0;0;0;0;0;0;0;0;0;0;0;0;0;0;0;0;X;X;X;X;X;X;X;X;X;X;X;X;X;X;X;X;X;X;X;X;X;X;X;X;X;0;0;0;0;0;0;0;X;X;X;X;X;X;X;0;0;0;0;0;0;0;0;0;0;0;0;0;0;0;0;0;0;0;0;0;0;0;0;0;0;X;X;X;X;X;X;X;0;0;0;0;0;0;0;0;0;0;0;0;X;X;X;X;X;0;0;0;0;0;0;0;0;0;0;0;0;0;0;0;0;0;0;X;X;X;X;X;X;0;0;0;0;0;0;0;0;0;0;0;0;0;0;0;0;0;0;0;0;0;0;0;0;0;0;0;0;0;0;0;0;0;0;0;0;0;0;0;0;0;0;0;0;0;0;0;0;X;X;X;X;X;X;X;X;X;X;X;X;0;0;0;0;0;0;0;0;X;X;X;X;X;X;X;0;0;0;0;0;0;0;0;0;0;0;0;0;0;0
0;0;0;0;0;0;0;0;0;0;0;0;0;0;0;0;0;X;X;X;X;X;X;X;X;X;X;X;X;X;X;X;X;X;X;X;X;X;X;X;X;X;0;0;0;0;0;0;0;X;X;X;X;X;X;X;0;0;0;0;0;0;0;0;0;0;0;0;0;0;0;0;0;0;0;0;0;0;0;0;0;0;X;X;X;X;X;X;X;0;0;0;0;0;0;0;0;0;0;0;0;X;X;X;X;X;0;0;0;0;0;0;0;0;0;0;0;0;0;0;0;0;0;0;X;X;X;X;X;X;0;0;0;0;0;0;0;0;0;0;0;0;0;0;0;0;0;0;0;0;0;0;0;0;0;0;0;0;0;0;0;0;0;0;0;0;0;0;0;0;0;0;0;0;0;0;0;0;X;X;X;X;X;X;X;X;X;X;X;X;0;0;0;0;0;0;0;0;X;X;X;X;X;X;X;0;0;0;0;0;0;0;0;0;0;0;0;0;0;0
0;0;0;0;0;0;0;0;0;0;0;0;0;0;0;0;0;X;X;X;X;X;X;X;X;X;X;X;X;X;X;X;X;X;X;X;X;X;X;X;X;X;0;0;0;0;0;0;0;X;X;X;X;X;X;X;0;0;0;0;0;0;0;0;0;0;0;0;0;0;0;0;0;0;0;0;0;0;0;0;0;0;X;X;X;X;X;X;X;0;0;0;0;0;0;0;0;0;0;0;0;X;X;X;X;X;0;0;0;0;0;0;0;0;0;0;0;0;0;0;0;0;0;0;X;X;X;X;X;X;0;0;0;0;0;0;0;0;0;0;0;0;0;0;0;0;0;0;0;0;0;0;0;0;0;0;0;0;0;0;0;0;0;0;0;0;0;0;0;0;0;0;0;0;0;0;0;0;X;X;X;X;X;X;X;X;X;X;X;X;0;0;0;0;0;0;0;0;X;X;X;X;X;X;X;0;0;0;0;0;0;0;0;0;0;0;0;0;0;0
0;0;0;0;0;0;0;0;0;0;0;0;0;0;0;0;0;X;X;X;X;X;X;X;X;X;X;X;X;X;X;X;X;X;X;X;X;X;X;X;X;X;0;0;0;0;0;0;0;X;X;X;X;X;X;X;0;0;0;0;0;0;0;0;0;0;0;0;0;0;0;0;0;0;0;0;0;0;0;0;0;0;X;X;X;X;X;X;X;0;0;0;0;0;0;0;0;0;0;0;0;X;X;X;X;X;0;0;0;0;0;0;0;0;0;0;0;0;0;0;0;0;0;0;X;X;X;X;X;X;0;0;0;0;0;0;0;0;0;0;0;0;0;0;0;0;0;0;0;0;0;0;0;0;0;0;0;0;0;0;0;0;0;0;0;0;0;0;0;0;0;0;0;0;0;0;0;0;X;X;X;X;X;X;X;X;X;X;X;X;0;0;0;0;0;0;0;0;X;X;X;X;X;X;X;0;0;0;0;0;0;0;0;0;0;0;0;0;0;0
0;0;0;0;0;0;0;0;0;0;0;0;0;0;0;0;0;X;X;X;X;X;X;X;X;X;X;X;X;X;X;X;X;X;X;X;X;X;X;X;X;X;0;0;0;0;0;0;0;X;X;X;X;X;X;X;0;0;0;0;0;0;0;0;0;0;0;0;0;0;0;0;0;0;0;0;0;0;0;0;0;0;X;X;X;X;X;X;X;0;0;0;0;0;0;0;0;0;0;0;0;X;X;X;X;X;0;0;0;0;0;0;0;0;0;0;0;0;0;0;0;0;0;0;X;X;X;X;X;X;0;0;0;0;0;0;0;0;0;0;0;0;0;0;0;0;0;0;0;0;0;0;0;0;0;0;0;0;0;0;0;0;0;0;0;0;0;0;0;0;0;0;0;0;0;0;0;0;X;X;X;X;X;X;X;X;X;X;X;X;0;0;0;0;0;0;0;0;X;X;X;X;X;X;X;0;0;0;0;0;0;0;0;0;0;0;0;0;0;0
0;0;0;0;0;0;0;0;0;0;0;0;0;0;0;0;0;X;X;X;X;X;X;X;X;X;X;X;X;X;X;X;X;X;X;X;X;X;X;X;X;X;0;0;0;0;0;0;0;X;X;X;X;X;X;X;0;0;0;0;0;0;0;0;0;0;0;0;0;0;0;0;0;0;0;0;0;0;0;0;0;0;X;X;X;X;X;X;X;0;0;0;0;0;0;0;0;0;0;0;0;X;X;X;X;X;0;0;0;0;0;0;0;0;0;0;0;0;0;0;0;0;0;0;X;X;X;X;X;X;0;0;0;0;0;0;0;0;0;0;0;0;0;0;0;0;0;0;0;0;0;0;0;0;0;0;0;0;0;0;0;0;0;0;0;0;0;0;0;0;0;0;0;0;0;0;0;0;X;X;X;X;X;X;X;X;X;X;X;X;0;0;0;0;0;0;0;0;X;X;X;X;X;X;X;0;0;0;0;0;0;0;0;0;0;0;0;0;0;0
0;0;0;0;0;0;0;0;0;0;0;0;0;0;0;0;0;X;X;X;X;X;X;X;X;X;X;X;X;X;X;X;X;X;X;X;X;X;X;X;X;X;0;0;0;0;0;0;0;X;X;X;X;X;X;X;0;0;0;0;0;0;0;0;0;0;0;0;0;0;0;0;0;0;0;0;0;0;0;0;0;0;X;X;X;X;X;X;X;0;0;0;0;0;0;0;0;0;0;0;0;X;X;X;X;X;0;0;0;0;0;0;0;0;0;0;0;0;0;0;0;0;0;0;X;w;w;w;w;X;0;0;0;0;0;0;0;0;0;0;0;0;0;0;0;0;0;0;0;0;0;0;0;0;0;0;0;0;0;0;0;0;0;0;0;0;0;0;0;0;0;0;0;0;0;0;0;0;X;X;X;X;X;X;X;X;X;X;X;X;0;0;0;0;0;0;0;0;X;X;X;X;X;X;X;0;0;0;0;0;0;0;0;0;0;0;0;0;0;0
0;0;0;0;0;0;0;0;0;0;0;0;0;0;0;0;0;X;X;X;X;X;X;X;X;X;X;X;X;X;X;X;X;X;X;X;X;X;X;X;X;X;0;0;0;0;0;0;0;X;X;X;X;X;X;X;0;0;0;0;0;0;0;0;0;0;0;0;0;0;0;0;0;0;0;0;0;0;0;0;0;0;X;X;X;X;X;X;X;0;0;0;0;0;0;0;0;0;0;0;0;X;w;w;w;X;0;0;0;0;0;0;0;0;0;0;0;0;0;0;0;0;0;0;X;w;w;w;w;X;0;0;0;0;0;0;0;0;0;0;0;0;0;0;0;0;0;0;0;0;0;0;0;0;0;0;0;0;0;0;0;0;0;0;0;0;0;0;0;0;0;0;0;0;0;0;0;0;X;X;X;X;X;X;X;X;X;X;X;X;0;0;0;0;0;0;0;0;X;w;w;w;w;w;X;0;0;0;0;0;0;0;0;0;0;0;0;0;0;0
0;0;0;0;0;0;0;0;0;0;0;0;0;0;0;0;0;X;X;X;X;X;X;X;X;X;X;X;X;X;X;X;X;X;X;X;X;X;X;X;X;X;0;0;0;0;0;0;0;X;X;X;X;X;X;X;0;0;0;0;0;0;0;0;0;0;0;0;0;0;0;0;0;0;0;0;0;0;0;0;0;0;X;X;X;X;X;X;X;0;0;0;0;0;0;0;0;0;0;0;0;X;w;w;w;X;0;0;0;0;0;0;0;0;0;0;0;0;0;0;0;0;0;0;X;X;X;X;X;X;0;0;0;0;0;0;0;0;0;0;0;0;0;0;0;0;0;0;0;0;0;0;0;0;0;0;0;0;0;0;0;0;0;0;0;0;0;0;0;0;0;0;0;0;0;0;0;0;X;X;X;X;X;X;X;X;X;X;X;X;0;0;0;0;0;0;0;0;X;w;w;w;w;w;X;0;0;0;0;0;0;0;0;0;0;0;0;0;0;0
0;0;0;0;0;0;0;0;0;0;0;0;0;0;0;0;0;X;X;X;X;X;X;X;X;X;X;X;X;X;X;X;X;X;X;X;X;X;X;X;X;X;0;0;0;0;0;0;0;X;X;X;X;X;X;X;0;0;0;0;0;0;0;0;0;0;0;0;0;0;0;0;0;0;0;0;0;0;0;0;0;0;X;X;X;X;X;X;X;0;0;0;0;0;0;0;0;0;0;0;0;X;w;w;w;X;0;0;0;0;0;0;0;0;0;0;0;0;0;0;0;0;0;0;X;X;X;X;X;X;0;0;0;0;0;0;0;0;0;0;0;0;0;0;0;0;0;0;0;0;0;0;0;0;0;0;0;0;0;0;0;0;0;0;0;0;0;0;0;0;0;0;0;0;0;0;0;0;X;X;X;X;X;X;X;X;X;X;X;X;0;0;0;0;0;0;0;0;X;w;w;w;w;w;X;0;0;0;0;0;0;0;0;0;0;0;0;0;0;0
0;0;0;0;0;0;0;0;0;0;0;0;0;0;0;0;0;X;X;X;X;X;X;X;X;X;X;X;X;X;X;X;X;X;X;X;X;X;X;X;X;X;0;0;0;0;0;0;0;X;X;X;X;X;X;X;0;0;0;0;0;0;0;0;0;0;0;0;0;0;0;0;0;0;0;0;0;0;0;0;0;0;X;X;X;X;X;X;X;0;0;0;0;0;0;0;0;0;0;0;0;X;w;w;w;X;0;0;0;0;0;0;0;0;0;0;0;0;0;0;0;0;0;0;X;X;X;X;X;X;0;0;0;0;0;0;0;0;0;0;0;0;0;0;0;0;0;0;0;0;0;0;0;0;0;0;0;0;0;0;0;0;0;0;0;0;0;0;0;0;0;0;0;0;0;0;0;0;X;w;w;w;w;w;w;w;w;w;w;X;0;0;0;0;0;w;w;0;X;X;X;X;X;X;X;0;0;0;0;0;0;0;X;X;X;X;X;X;X;X
0;0;0;0;0;0;0;0;0;0;0;0;0;0;0;0;0;X;X;X;X;X;X;X;w;w;w;w;w;X;X;X;X;X;X;X;X;X;X;X;X;X;0;0;0;0;0;0;0;X;X;X;X;X;X;X;0;0;0;0;0;0;0;0;0;0;0;0;0;0;0;0;0;0;0;0;0;0;0;0;0;0;X;X;X;X;X;X;X;0;0;0;0;0;0;0;0;0;0;0;0;X;w;w;w;X;0;0;0;0;0;0;0;0;0;0;0;0;0;0;0;0;0;0;X;X;X;X;X;X;0;0;0;0;0;0;0;0;0;0;0;0;0;0;0;0;0;0;0;0;0;0;0;0;0;0;0;0;0;0;0;0;0;0;0;0;0;0;0;0;0;0;0;0;0;0;0;0;X;w;w;w;w;w;w;w;w;w;w;X;0;0;0;0;0;w;w;0;X;X;X;X;X;X;X;0;0;0;0;0;0;0;X;X;X;X;X;X;X;X
0;0;0;0;0;0;0;0;0;0;0;0;0;0;0;0;0;X;w;w;w;w;w;w;w;w;w;w;w;w;w;w;w;w;w;X;X;X;X;X;X;X;0;0;0;0;0;0;0;X;X;X;X;X;X;X;0;0;0;0;0;0;0;0;0;0;0;0;0;0;0;0;0;0;0;0;0;0;0;0;0;0;X;X;X;X;X;X;X;0;0;0;0;0;0;0;0;0;0;0;0;X;X;X;X;X;0;0;0;0;0;0;0;0;0;0;0;0;0;0;0;0;0;0;X;X;X;X;X;X;0;0;0;0;0;0;0;0;0;0;0;0;0;0;0;0;0;0;0;0;0;0;0;0;0;0;0;0;0;0;0;0;0;0;0;0;0;0;0;0;0;0;0;0;0;0;0;0;X;X;X;X;X;w;w;X;X;X;X;X;0;0;0;0;0;0;0;0;X;X;X;X;X;X;X;0;0;0;0;0;0;0;X;X;X;X;X;X;X;X
0;0;0;0;0;0;0;0;0;0;0;0;0;0;0;0;0;X;w;w;w;w;w;w;w;w;w;w;w;w;w;w;w;w;w;w;w;w;w;w;w;X;0;0;0;0;0;0;0;X;w;w;w;w;w;X;0;0;0;0;0;0;0;0;0;0;0;0;0;0;0;0;0;0;0;0;0;0;0;0;0;0;X;X;X;X;X;X;X;0;0;0;0;0;0;0;0;0;0;0;0;X;X;X;X;X;0;0;0;0;0;0;0;0;0;0;0;0;0;0;0;0;0;0;X;X;X;X;X;X;0;0;0;0;0;0;0;0;0;0;0;0;0;0;0;0;0;0;0;0;0;0;0;0;0;0;0;0;0;0;0;0;0;0;0;0;0;0;0;0;0;0;0;0;0;0;0;0;X;X;X;X;X;w;w;X;X;X;X;X;0;0;0;0;0;0;0;0;X;X;X;X;X;X;X;0;0;0;0;0;0;0;X;X;X;X;X;X;X;X
0;0;0;0;0;0;0;0;0;0;0;0;0;0;0;0;0;X;w;w;w;w;w;w;w;w;w;w;w;w;w;w;w;w;w;w;w;w;w;w;w;X;0;0;0;0;0;0;0;X;w;w;w;w;w;X;0;0;0;0;0;0;0;0;0;0;0;0;0;0;0;0;0;0;0;0;0;0;0;0;0;0;X;X;X;X;X;X;X;0;0;0;0;0;0;0;0;0;0;0;0;X;X;X;X;X;0;0;0;0;0;0;0;0;0;0;0;0;0;0;0;0;0;0;X;X;X;X;X;X;0;0;0;0;0;0;0;0;0;0;0;0;0;0;0;0;0;0;0;0;0;0;0;0;0;0;0;0;0;0;0;0;0;0;0;0;0;0;0;0;0;0;0;0;0;0;0;0;X;X;X;X;X;w;w;X;X;X;X;X;0;0;0;0;0;0;0;0;X;X;X;X;X;X;X;0;0;0;0;0;0;0;X;X;X;X;X;X;X;X
X;X;X;X;X;X;X;X;0;0;0;0;0;0;0;0;0;X;w;w;w;w;w;X;X;X;X;X;X;X;w;w;w;w;w;w;w;w;w;w;w;X;0;0;0;0;0;0;0;X;w;w;w;w;w;X;0;0;0;0;0;0;0;0;0;0;0;0;0;0;0;0;0;0;0;0;0;0;0;0;0;0;X;w;w;w;w;w;X;0;0;0;0;0;0;0;0;0;0;0;0;X;X;X;X;X;0;0;0;0;0;0;0;0;0;0;0;0;0;0;0;0;0;0;X;X;X;X;X;X;0;0;0;0;0;0;0;0;0;0;0;0;0;0;0;0;0;0;0;0;0;0;0;0;0;0;0;0;0;0;0;0;0;0;0;0;0;0;0;0;0;0;0;0;0;0;0;0;X;X;X;X;X;w;w;X;X;X;X;X;0;0;0;0;0;0;0;0;X;X;X;X;X;X;X;0;0;0;0;0;0;0;X;X;X;X;X;X;X;X
X;X;X;X;X;X;X;X;0;0;0;0;0;w;w;0;0;X;X;X;X;X;X;X;X;X;X;X;X;X;X;X;X;X;X;X;w;w;w;w;w;X;0;0;0;0;0;0;0;X;w;w;w;w;w;X;0;0;0;0;0;0;0;0;0;0;0;0;0;0;0;0;0;0;0;0;0;0;0;0;0;0;X;w;w;w;w;w;X;0;0;0;0;0;0;0;0;0;0;0;0;X;X;X;X;X;0;0;0;0;0;0;0;0;0;0;0;0;0;0;0;0;0;0;X;X;X;X;X;X;0;0;0;0;0;0;0;0;0;0;0;0;0;0;0;0;0;0;0;0;0;0;0;0;0;0;0;0;0;0;0;0;0;0;0;0;0;0;0;0;0;0;0;0;0;0;0;0;X;X;X;X;X;w;w;X;X;X;X;X;0;0;0;0;0;0;0;0;X;X;X;X;X;X;X;0;0;0;0;0;0;0;X;X;X;X;X;X;X;X
X;X;X;X;X;X;X;X;0;0;0;0;0;w;w;0;0;X;X;X;X;X;X;X;X;X;X;X;X;X;X;X;X;X;X;X;X;X;X;X;X;X;0;0;0;0;0;0;0;X;X;X;X;X;X;X;0;0;0;0;0;0;0;0;0;0;0;0;0;0;0;0;0;0;0;0;0;0;0;0;0;0;X;w;w;w;w;w;X;0;0;0;0;0;0;0;0;0;0;0;0;X;X;X;X;X;0;0;0;0;0;0;0;0;0;0;0;0;0;0;0;0;0;0;X;X;X;X;X;X;0;0;0;0;0;0;0;0;0;0;0;0;0;0;0;0;0;0;0;0;0;0;0;0;0;0;0;0;0;0;0;0;0;0;0;0;0;0;0;0;0;0;0;0;0;0;0;0;X;X;X;X;X;w;w;X;X;X;X;X;0;0;0;0;0;0;0;0;X;X;X;X;X;X;X;0;0;0;0;0;0;0;X;X;X;X;X;X;X;X
X;X;X;X;X;X;X;X;0;0;0;0;0;0;0;0;0;X;X;X;X;X;X;X;X;X;X;X;X;X;X;X;X;X;X;X;X;X;X;X;X;X;0;0;0;0;0;0;0;X;X;X;X;X;X;X;0;0;0;0;0;0;0;0;0;0;0;0;0;0;0;0;0;0;0;0;0;0;0;0;0;0;X;X;X;X;X;X;X;0;0;0;0;0;0;0;0;0;0;0;0;X;X;X;X;X;0;0;0;0;0;0;0;0;0;0;0;0;0;0;0;0;0;0;X;X;X;X;X;X;0;0;0;0;0;0;0;0;0;0;0;0;0;0;0;0;0;0;0;0;0;0;0;0;0;0;0;0;0;0;0;0;0;0;0;0;0;0;0;0;0;0;0;0;0;0;0;0;X;X;X;X;X;w;w;X;X;X;X;X;0;0;0;0;0;0;0;0;X;X;X;X;X;X;X;0;0;0;0;0;0;0;X;X;X;X;X;X;X;X
X;X;X;X;X;X;X;X;0;0;0;0;0;0;0;0;0;X;X;X;X;X;X;X;X;X;X;X;X;X;X;X;X;X;X;X;X;X;X;X;X;X;0;0;0;0;0;0;0;X;X;X;X;X;X;X;0;0;0;0;0;0;0;0;0;0;0;0;0;0;0;0;0;w;w;w;0;0;0;0;0;0;X;X;X;X;X;X;X;0;0;0;0;0;0;0;0;0;0;0;0;X;X;X;X;X;0;0;0;0;0;0;0;0;0;0;0;0;0;0;0;0;0;0;X;X;X;X;X;X;0;0;0;0;0;0;0;0;0;0;0;0;0;0;0;0;0;0;0;0;0;0;0;0;0;0;0;0;0;0;0;0;0;0;0;0;0;0;0;0;0;0;0;0;0;0;0;0;X;X;X;X;X;w;w;X;X;X;X;X;0;0;0;0;0;0;0;0;X;X;X;X;X;X;X;0;0;0;0;0;0;0;X;X;X;X;X;X;X;X
X;X;X;X;X;X;X;X;0;0;0;0;0;0;0;0;0;X;X;X;X;X;X;X;X;X;X;X;X;X;X;X;X;X;X;X;X;X;X;X;X;X;0;0;0;0;0;0;0;X;X;X;X;X;X;X;0;0;0;0;0;0;0;0;0;0;0;0;0;0;0;0;0;w;w;w;0;0;0;0;0;0;X;X;X;X;X;X;X;0;0;0;0;0;0;0;0;0;0;0;0;X;X;X;X;X;0;0;0;0;0;0;0;0;0;0;0;0;0;0;0;0;0;0;X;X;X;X;X;X;0;0;0;0;0;0;0;0;0;0;0;0;0;0;0;0;0;0;0;0;0;0;0;0;0;0;0;0;0;0;0;0;0;0;0;0;0;0;0;0;0;0;0;0;0;0;0;0;X;X;X;X;X;w;w;X;X;X;X;X;0;0;0;0;0;0;0;0;X;X;X;X;X;X;X;0;0;0;0;0;0;0;X;X;X;X;X;X;X;X
X;X;X;X;X;X;X;X;0;0;0;0;0;0;0;0;0;X;X;X;X;X;X;X;X;X;X;X;X;X;X;X;X;X;X;X;X;X;X;X;X;X;0;0;0;0;0;0;0;X;X;X;X;X;X;X;0;0;0;0;0;0;0;0;0;0;0;0;0;0;0;0;0;0;0;0;0;0;0;0;0;0;X;X;X;X;X;X;X;0;0;0;0;0;0;0;0;0;0;0;0;X;X;X;X;X;0;0;0;0;0;0;0;0;0;0;0;0;0;0;0;0;0;0;X;X;X;X;X;X;0;0;0;0;0;0;0;0;0;0;0;0;0;0;0;0;0;0;0;0;0;0;0;0;0;0;0;0;0;0;0;0;0;0;0;0;0;0;0;0;0;0;0;0;0;0;0;0;X;X;X;X;X;X;X;X;X;X;X;X;0;0;0;0;0;0;0;0;X;X;X;X;X;X;X;0;0;0;0;0;0;0;X;X;X;X;X;X;X;X
X;X;X;X;X;X;X;X;0;0;0;0;0;0;0;0;0;X;X;X;X;X;X;X;X;X;X;X;X;X;X;X;X;X;X;X;X;X;X;X;X;X;0;0;0;0;0;0;0;X;X;X;X;X;X;X;0;0;0;0;0;0;0;0;0;0;0;0;0;0;0;0;0;0;0;0;0;0;0;0;0;0;X;X;X;X;X;X;X;0;0;0;0;0;0;0;0;0;0;0;0;X;X;X;X;X;0;0;0;0;0;0;0;0;0;0;0;0;0;0;0;0;0;0;X;X;X;X;X;X;0;0;0;0;0;0;0;0;0;0;0;0;0;0;0;0;0;0;0;0;0;0;0;0;0;0;0;0;0;0;0;0;0;0;0;0;0;0;0;0;0;0;0;0;0;0;0;0;X;X;X;X;X;X;X;X;X;X;X;X;0;0;0;0;0;0;0;0;X;X;X;X;X;X;X;0;0;0;0;0;0;0;X;X;X;X;X;X;X;X
X;X;X;X;X;X;X;X;0;0;0;0;0;0;0;0;0;X;X;X;X;X;X;X;X;X;X;X;X;X;X;X;X;X;X;X;X;X;X;X;X;X;0;0;0;0;0;0;0;X;X;X;X;X;X;X;0;0;0;0;0;0;0;0;0;0;0;0;0;0;0;0;0;0;0;0;0;0;0;0;0;0;X;X;X;X;X;X;X;0;0;0;0;0;0;0;0;0;0;0;0;X;X;X;X;X;0;0;0;0;0;0;0;0;0;0;0;0;0;0;0;0;0;0;X;X;X;X;X;X;0;0;0;0;0;0;0;0;0;0;0;0;0;0;0;0;0;0;0;0;0;0;0;0;0;0;0;0;0;0;0;0;0;0;0;0;0;0;0;0;0;0;0;0;0;0;0;0;X;X;X;X;X;X;X;X;X;X;X;X;0;0;0;0;0;0;0;0;X;X;X;X;X;X;X;0;0;0;0;0;0;0;X;X;X;X;X;X;X;X
X;X;X;X;X;X;X;X;0;0;0;0;0;0;0;0;0;X;X;X;X;X;X;X;X;X;X;X;X;X;X;X;X;X;X;X;X;X;X;X;X;X;0;0;0;0;0;0;0;X;X;X;X;X;X;X;0;0;0;0;0;0;0;0;0;0;0;0;0;0;0;0;0;0;0;0;0;0;0;0;0;0;X;X;X;X;X;X;X;0;0;0;0;0;0;0;0;0;0;0;0;X;X;X;X;X;0;0;0;0;0;0;0;0;0;0;0;0;0;0;0;0;0;0;X;X;X;X;X;X;0;0;0;0;0;0;0;0;0;0;0;0;0;0;0;0;0;0;0;0;0;0;0;0;0;0;0;0;0;0;0;0;0;0;0;0;0;0;0;0;0;0;0;0;0;0;0;0;X;X;X;X;X;X;X;X;X;X;X;X;0;0;0;0;0;0;0;0;X;X;X;X;X;X;X;0;0;0;0;0;0;0;X;X;X;X;X;X;X;X
X;X;X;X;X;X;X;X;0;0;0;0;0;0;0;0;0;X;X;X;X;X;X;X;X;X;X;X;X;X;X;X;X;X;X;X;X;X;X;X;X;X;0;0;0;0;0;0;0;X;X;X;X;X;X;X;0;0;0;0;0;0;0;0;0;0;0;0;0;0;0;0;0;0;0;0;0;0;0;0;0;0;X;X;X;X;X;X;X;0;0;0;0;0;0;0;0;0;0;0;0;X;X;X;X;X;0;0;0;0;0;0;0;0;0;0;0;0;0;0;0;0;0;0;X;X;X;X;X;X;0;0;0;0;0;0;0;0;0;0;0;0;0;0;0;0;0;0;0;0;0;0;0;0;0;0;0;0;0;0;0;0;0;0;0;0;0;0;0;0;0;0;0;0;0;0;0;0;X;X;X;X;X;X;X;X;X;X;X;X;0;0;0;0;0;0;0;0;X;X;X;X;X;X;X;0;0;0;0;0;0;0;X;X;X;X;X;X;X;X
X;X;X;X;X;X;X;X;0;0;0;0;0;0;0;0;0;X;X;X;X;X;X;X;X;X;X;X;X;X;X;X;X;X;X;X;X;X;X;X;X;X;0;0;0;0;0;0;0;X;X;X;X;X;X;X;0;0;0;0;0;0;0;0;0;0;0;0;0;0;0;0;0;0;0;0;0;0;0;0;0;0;X;X;X;X;X;X;X;0;0;0;0;0;0;0;0;0;0;0;0;X;X;X;X;X;0;0;0;0;0;0;0;0;0;0;0;0;0;0;0;0;0;0;X;X;X;X;X;X;0;0;0;0;0;0;0;0;0;0;0;0;0;0;0;0;0;0;0;0;0;0;0;0;0;0;0;0;0;0;0;0;0;0;0;0;0;0;0;0;0;0;0;0;0;0;0;0;X;X;X;X;X;X;X;X;X;X;X;X;0;0;0;0;0;0;0;0;X;X;X;X;X;X;X;0;0;0;0;0;0;0;X;X;X;X;X;X;X;X
X;X;X;X;X;X;X;X;0;0;0;0;0;0;0;0;0;X;X;X;X;X;X;X;X;X;X;X;X;X;X;X;X;X;X;X;X;X;X;X;X;X;0;0;0;0;0;0;0;X;X;X;X;X;X;X;0;0;0;0;0;0;0;0;0;0;0;0;0;0;0;0;0;0;0;0;0;0;0;0;0;0;X;X;X;X;X;X;X;0;0;0;0;0;0;0;0;0;0;0;0;X;X;X;X;X;0;0;0;0;0;0;0;0;0;0;0;0;0;0;0;0;0;0;X;X;X;X;X;X;0;0;0;0;0;0;0;0;0;0;0;0;0;0;0;0;0;0;0;0;0;0;0;0;0;0;0;0;0;0;0;0;0;0;0;0;0;0;0;0;0;0;0;0;0;0;0;0;X;X;X;X;X;X;X;X;X;X;X;X;0;0;0;0;0;0;0;0;X;X;X;X;X;X;X;0;0;0;0;0;0;0;X;X;X;X;X;X;X;X
X;X;X;X;X;X;X;X;0;0;0;0;0;0;0;0;0;X;X;X;X;X;X;X;X;X;X;X;X;X;X;X;X;X;X;X;X;X;X;X;X;X;0;0;0;0;0;0;0;X;X;X;X;X;X;X;0;0;0;0;0;0;0;0;0;0;0;0;0;0;0;0;0;0;0;0;0;0;0;0;0;0;X;X;X;X;X;X;X;0;0;0;0;0;0;0;0;0;0;0;0;X;X;X;X;X;0;0;0;0;0;0;0;0;0;0;0;0;0;0;0;0;0;0;X;X;X;X;X;X;0;0;0;0;0;0;0;0;0;0;0;0;0;0;0;0;0;0;0;0;0;0;0;0;0;0;0;0;0;0;0;0;0;0;0;0;0;0;0;0;0;0;0;0;0;0;0;0;X;X;X;X;X;X;X;X;X;X;X;X;0;0;0;0;0;0;0;0;X;X;X;X;X;X;X;0;0;0;0;0;0;0;X;X;X;X;X;X;X;X
