1 1 1 1 1 1 1 0 0 0 0 0 1 1 1 1 1 1 1 1 1 1 1
1 0 0 0 0 0 0 0 0 0 0 0 0 0 0 0 0 0 0 0 0 0 1
1 0 0 0 0 0 0 0 0 P 0 0 0 0 0 0 0 0 0 0 0 0 0
1 0 0 0 0 0 0 0 0 0 0 0 0 0 0 0 0 0 0 0 0 0 0
1 0 0 0 0 0 0 0 0 0 0 0 0 0 0 0 0 0 0 0 0 0 0
1 0 0 0 0 0 0 0 0 0 0 0 0 0 0 0 0 0 0 0 0 0 0
1 0 0 0 0 0 0 0 0 0 0 0 0 0 0 0 0 0 0 0 0 0 0
1 0 0 0 0 0 0 0 S 0 0 0 0 0 0 0 0 0 0 0 0 0 0
1 0 0 0 0 0 0 0 0 0 0 0 0 0 0 0 0 0 0 0 0 0 0
1 0 0 0 0 0 0 0 0 0 0 0 0 0 0 0 0 0 0 0 0 0 0
1 0 0 0 0 0 0 0 0 0 0 0 0 0 0 0 0 0 0 0 0 0 0
1 0 0 0 0 D D D D 1 1 0 0 0 0 0 0 0 0 0 0 0 0
1 0 S 0 0 D D D D 1 1 0 0 0 0 0 0 0 0 0 0 0 0
1 0 0 0 0 D D D D 1 1 1 1 0 0 0 0 S 0 0 0 0 0
1 0 0 0 0 D D D D 1 1 1 1 0 S 0 0 0 0 0 0 0 0
1 0 0 0 0 D D D D 1 1 1 1 0 0 0 0 0 0 0 0 0 0
1 0 0 0 0 D D D D 0 0 0 0 0 0 0 0 0 0 0 S 0 0
1 0 0 0 0 D D D D 0 0 0 0 0 0 0 0 0 0 0 0 0 0
1 0 0 0 0 D D D D 0 0 0 0 0 0 0 0 0 0 0 0 0 0
1 0 0 S 0 D D D D 0 0 0 0 0 0 S 0 0 0 0 0 0 0
1 0 0 0 0 D D D D 0 0 S 0 0 0 0 0 0 0 0 0 0 0
1 0 0 0 0 D D D D 0 0 0 0 0 0 0 0 0 0 0 0 0 0
1 0 0 0 0 D D D D 0 0 0 0 0 0 0 0 0 0 0 0 0 0
1 0 0 0 0 D D D D 0 0 0 0 0 0 0 0 0 0 0 0 0 0
1 0 0 0 0 D D D D 0 0 0 0 0 0 0 0 0 0 0 0 0 0
1 0 0 0 0 D D D D 0 0 0 0 0 0 0 0 0 0 0 0 0 ^
1 0 0 0 0 D D D D 0 0 0 0 0 0 0 0 0 0 0 0 0 D
1 0 0 0 0 1 1 1 1 1 1 1 1 1 1 1 1 1 1 1 1 1 D
1 0 0 0 0 0 0 1 1 1 1 1 1 1 1 1 1 1 1 1 1 1 D
1 0 0 0 0 0 0 1 1 1 1 1 1 1 1 1 1 1 1 1 1 1 D
1 0 0 0 0 0 0 0 0 0 0 0 0 0 0 0 0 0 0 0 0 0 0
1 0 0 0 0 0 0 0 0 0 0 0 0 0 0 0 0 0 0 0 0 0 0
1 0 0 0 0 0 0 0 0 0 0 0 0 0 0 0 0 0 0 0 0 0 0
1 0 0 0 0 0 0 0 0 0 0 0 0 0 0 0 0 0 0 0 0 0 0
1 0 0 0 0 0 0 0 0 0 0 0 0 0 0 0 0 0 0 0 0 0 0
1 0 0 0 0 0 0 0 0 0 0 0 0 0 0 0 0 0 0 0 0 0 0
1 0 0 0 0 0 ^ 0 0 0 0 S 0 0 0 0 0 0 0 0 0 0 0
1 0 0 0 0 0 1 0 0 P 0 1 S 0 0 0 0 0 0 0 0 0 0
1 0 0 0 0 0 0 0 0 0 0 1 1 1 0 0 0 0 0 0 0 0 0
1 1 1 1 1 1 0 0 0 0 0 0 1 1 0 0 0 0 0 0 0 0 0
