Z;Z;Z;Z;Z;Z;Z;Z;Z;Z;Z;Z;Z;Z;Z;Z;Z;Z;Z;Z;Z;Z;Z;Z;Z;Z;Z;Z;Z;Z;Z;Z;Z;Z;Z;Z;Z;Z;Z;Z;Z;Z;Z;Z;Z;Z;Z;Z;Z;Z;Z;Z;Z;Z;Z;Z;Z;Z;Z;Z;Z;Z;Z;Z;Z;Z;Z;Z;Z;Z;Z;Z;Z;Z;Z;Z;Z;Z;Z;Z;Z;Z;Z;Z;Z;Z;Z;Z;Z;Z;Z;Z;Z;Z;Z;Z;Z;Z;Z;Z;Z;Z;Z;Z;Z;Z;Z;Z;Z;Z;Z;Z;Z;Z;Z;Z;Z;Z;Z;Z;Z;Z;Z;Z;Z;Z;Z;Z;Z;Z;Z;Z;Z;Z;Z;Z;Z;Z;Z;Z;Z;Z;Z;Z;Z;Z;Z;Z;Z;Z;Z;Z;Z;Z;Z;Z;Z;Z;Z;Z;Z;Z;Z;Z;Z;Z;Z;Z;Z;Z;Z;Z;Z;Z;Z;Z;Z;Z;Z;Z;Z;Z;Z;Z;Z;Z;Z;Z;Z;Z
Z;Z;Z;Z;Z;Z;Z;Z;Z;Z;Z;Z;Z;Z;Z;Z;Z;Z;Z;Z;Z;Z;Z;Z;Z;Z;Z;Z;Z;Z;Z;Z;Z;Z;Z;Z;Z;Z;Z;Z;Z;Z;Z;Z;Z;Z;Z;Z;Z;Z;Z;Z;Z;Z;Z;Z;Z;Z;Z;Z;Z;Z;Z;Z;Z;Z;Z;Z;Z;Z;Z;Z;Z;Z;Z;Z;Z;Z;Z;Z;Z;Z;Z;Z;Z;Z;Z;Z;Z;Z;Z;Z;Z;Z;Z;Z;Z;Z;Z;Z;Z;Z;Z;Z;Z;Z;Z;Z;Z;Z;Z;Z;Z;Z;Z;Z;Z;Z;Z;Z;Z;Z;Z;Z;Z;Z;Z;Z;Z;Z;Z;Z;Z;Z;Z;Z;Z;Z;Z;Z;Z;Z;Z;Z;Z;Z;Z;Z;Z;Z;Z;Z;Z;Z;Z;Z;Z;Z;Z;Z;Z;Z;Z;Z;Z;Z;Z;Z;Z;Z;Z;Z;Z;Z;Z;Z;Z;Z;Z;Z;Z;Z;Z;Z;Z;Z;Z;Z;Z;Z
Z;Z;Z;Z;Z;Z;Z;Z;Z;Z;Z;Z;Z;Z;Z;Z;Z;Z;Z;Z;Z;Z;Z;Z;Z;Z;Z;Z;Z;Z;Z;Z;Z;Z;Z;Z;Z;Z;Z;Z;Z;Z;Z;Z;Z;Z;Z;Z;Z;Z;Z;Z;Z;Z;Z;Z;Z;Z;Z;Z;Z;Z;Z;Z;Z;Z;Z;Z;Z;Z;Z;Z;Z;Z;Z;Z;Z;Z;Z;Z;Z;Z;Z;Z;Z;Z;Z;Z;Z;Z;Z;Z;Z;Z;Z;Z;Z;Z;Z;Z;Z;Z;Z;Z;Z;Z;Z;Z;Z;Z;Z;Z;Z;Z;Z;Z;Z;Z;Z;Z;Z;Z;Z;Z;Z;Z;Z;Z;Z;Z;Z;Z;Z;Z;Z;Z;Z;Z;Z;Z;Z;Z;Z;Z;Z;Z;Z;Z;Z;Z;Z;Z;Z;Z;Z;Z;Z;Z;Z;Z;Z;Z;Z;Z;Z;Z;Z;Z;Z;Z;Z;Z;Z;Z;Z;Z;Z;Z;Z;Z;Z;Z;Z;Z;Z;Z;Z;Z;Z;Z
Z;Z;Z;Z;Z;Z;Z;Z;Z;Z;Z;Z;Z;Z;Z;Z;Z;Z;Z;Z;Z;Z;Z;Z;Z;Z;Z;Z;Z;Z;Z;Z;Z;Z;Z;Z;Z;Z;Z;Z;Z;Z;Z;Z;Z;Z;Z;Z;Z;Z;Z;Z;Z;Z;Z;Z;Z;Z;Z;Z;Z;Z;Z;Z;Z;Z;Z;Z;Z;Z;Z;Z;Z;Z;Z;Z;Z;Z;Z;Z;Z;Z;Z;Z;Z;Z;Z;Z;Z;Z;Z;Z;Z;Z;Z;Z;Z;Z;Z;Z;Z;Z;Z;Z;Z;Z;Z;Z;Z;Z;Z;Z;Z;Z;Z;Z;Z;Z;Z;Z;Z;Z;Z;Z;Z;Z;Z;Z;Z;Z;Z;Z;Z;Z;Z;Z;Z;Z;Z;Z;Z;Z;Z;Z;Z;Z;Z;Z;Z;Z;Z;Z;Z;Z;Z;Z;Z;Z;Z;Z;Z;Z;Z;Z;Z;Z;Z;Z;Z;Z;Z;Z;Z;Z;Z;Z;Z;Z;Z;Z;Z;Z;Z;Z;Z;Z;Z;Z;Z;Z
Z;Z;Z;Z;Z;Z;Z;Z;Z;Z;Z;Z;Z;Z;Z;Z;Z;Z;Z;Z;Z;Z;Z;Z;Z;Z;Z;Z;Z;Z;Z;Z;Z;Z;Z;Z;Z;Z;Z;Z;Z;Z;Z;Z;Z;Z;Z;Z;Z;Z;Z;Z;Z;Z;Z;Z;Z;Z;Z;Z;Z;Z;Z;Z;Z;Z;Z;Z;Z;Z;Z;Z;Z;Z;Z;Z;Z;Z;Z;Z;Z;Z;Z;Z;Z;Z;Z;Z;Z;Z;Z;Z;Z;Z;Z;Z;Z;Z;Z;Z;Z;Z;Z;Z;Z;Z;Z;Z;Z;Z;Z;Z;Z;Z;Z;Z;Z;Z;Z;Z;Z;Z;Z;Z;Z;Z;Z;Z;Z;Z;Z;Z;Z;Z;Z;Z;Z;Z;Z;Z;Z;Z;Z;Z;Z;Z;Z;Z;Z;Z;Z;Z;Z;Z;Z;Z;Z;Z;Z;Z;Z;Z;Z;Z;Z;Z;Z;Z;Z;Z;Z;Z;Z;Z;Z;Z;Z;Z;Z;Z;Z;Z;Z;Z;Z;Z;Z;Z;Z;Z
Z;Z;Z;Z;Z;Z;Z;Z;Z;Z;Z;Z;Z;Z;Z;Z;Z;Z;Z;Z;Z;Z;Z;Z;Z;Z;Z;Z;Z;Z;Z;Z;Z;Z;Z;Z;Z;Z;Z;Z;Z;Z;Z;Z;Z;Z;Z;Z;Z;Z;Z;Z;Z;Z;Z;Z;Z;Z;Z;Z;Z;Z;Z;Z;Z;Z;Z;Z;Z;Z;Z;Z;Z;Z;Z;Z;Z;Z;Z;Z;Z;Z;Z;Z;Z;Z;Z;Z;Z;Z;Z;Z;Z;Z;Z;Z;Z;Z;Z;Z;Z;Z;Z;Z;Z;Z;Z;Z;Z;Z;Z;Z;Z;Z;Z;Z;Z;Z;Z;Z;Z;Z;Z;Z;Z;Z;Z;Z;Z;Z;Z;Z;Z;Z;Z;Z;Z;Z;Z;Z;Z;Z;Z;Z;Z;Z;Z;Z;Z;Z;Z;Z;Z;Z;Z;Z;Z;Z;Z;Z;Z;Z;Z;Z;Z;Z;Z;Z;Z;Z;Z;Z;Z;Z;Z;Z;Z;Z;Z;Z;Z;Z;Z;Z;Z;Z;Z;Z;Z;Z
Z;Z;Z;Z;Z;Z;Z;Z;Z;Z;Z;Z;Z;Z;Z;Z;Z;Z;Z;Z;Z;Z;Z;Z;Z;Z;Z;Z;Z;Z;Z;Z;Z;Z;Z;Z;Z;Z;Z;Z;Z;Z;Z;Z;Z;Z;Z;Z;Z;Z;Z;Z;Z;Z;Z;Z;Z;Z;Z;Z;Z;Z;Z;Z;Z;Z;Z;Z;Z;Z;Z;Z;Z;Z;Z;Z;Z;Z;Z;Z;Z;Z;Z;Z;Z;Z;Z;Z;Z;Z;Z;Z;Z;Z;Z;Z;Z;Z;Z;Z;Z;Z;Z;Z;Z;Z;Z;Z;Z;Z;Z;Z;Z;Z;Z;Z;Z;Z;Z;Z;Z;Z;Z;Z;Z;Z;Z;Z;Z;Z;Z;Z;Z;Z;Z;Z;Z;Z;Z;Z;Z;Z;Z;Z;Z;Z;Z;Z;Z;Z;Z;Z;Z;Z;Z;Z;Z;Z;Z;Z;Z;Z;Z;Z;Z;Z;Z;Z;Z;Z;Z;Z;Z;Z;Z;Z;Z;Z;Z;Z;Z;Z;Z;Z;Z;Z;Z;Z;Z;Z
Z;Z;Z;Z;Z;Z;Z;Z;Z;Z;Z;Z;Z;Z;Z;Z;Z;Z;Z;Z;Z;Z;Z;Z;Z;Z;Z;Z;Z;Z;Z;Z;Z;Z;Z;Z;Z;Z;Z;Z;Z;Z;Z;Z;Z;Z;Z;Z;Z;Z;Z;Z;Z;Z;Z;Z;Z;Z;Z;Z;Z;Z;Z;Z;Z;Z;Z;Z;Z;Z;Z;Z;Z;Z;Z;Z;Z;Z;Z;Z;Z;Z;Z;Z;Z;Z;Z;Z;Z;Z;Z;Z;Z;Z;Z;Z;Z;Z;Z;Z;Z;Z;Z;Z;Z;Z;Z;Z;Z;Z;Z;Z;Z;Z;Z;Z;Z;Z;Z;Z;Z;Z;Z;Z;Z;Z;Z;Z;Z;Z;Z;Z;Z;Z;Z;Z;Z;Z;Z;Z;Z;Z;Z;Z;Z;Z;Z;Z;Z;Z;Z;Z;Z;Z;Z;Z;Z;Z;Z;Z;Z;Z;Z;Z;Z;Z;Z;Z;Z;Z;Z;Z;Z;Z;Z;Z;Z;Z;Z;Z;Z;Z;Z;Z;Z;Z;Z;Z;Z;Z
Z;Z;Z;Z;Z;Z;Z;Z;Z;Z;Z;Z;Z;Z;Z;Z;Z;Z;Z;Z;Z;Z;Z;Z;Z;Z;Z;Z;Z;Z;Z;Z;Z;Z;Z;Z;Z;Z;Z;Z;Z;Z;Z;Z;Z;Z;Z;Z;Z;Z;Z;Z;Z;Z;Z;Z;Z;Z;Z;Z;Z;Z;Z;Z;Z;Z;Z;Z;Z;Z;Z;Z;Z;Z;Z;Z;Z;Z;Z;Z;Z;Z;Z;Z;Z;Z;Z;Z;Z;Z;Z;Z;Z;Z;Z;Z;Z;Z;Z;Z;Z;Z;Z;Z;Z;Z;Z;Z;Z;Z;Z;Z;Z;Z;Z;Z;Z;Z;Z;Z;Z;Z;Z;Z;Z;Z;Z;Z;Z;Z;Z;Z;Z;Z;Z;Z;Z;Z;Z;Z;Z;Z;Z;Z;Z;Z;Z;Z;Z;Z;Z;Z;Z;Z;Z;Z;Z;Z;Z;Z;Z;Z;Z;Z;Z;Z;Z;Z;Z;Z;Z;Z;Z;Z;Z;Z;Z;Z;Z;Z;Z;Z;Z;Z;Z;Z;Z;Z;Z;Z
Z;Z;Z;Z;Z;Z;Z;Z;Z;Z;Z;Z;Z;Z;Z;Z;Z;Z;Z;Z;Z;Z;Z;Z;Z;Z;Z;Z;Z;Z;Z;Z;Z;Z;Z;Z;Z;Z;Z;Z;Z;Z;Z;Z;Z;Z;Z;Z;Z;Z;Z;Z;Z;Z;Z;Z;Z;Z;Z;Z;Z;Z;Z;Z;Z;Z;Z;Z;Z;Z;Z;Z;Z;Z;Z;Z;Z;Z;Z;Z;Z;Z;Z;Z;Z;Z;Z;Z;Z;Z;Z;Z;Z;Z;Z;Z;Z;Z;Z;Z;Z;Z;Z;Z;Z;Z;Z;Z;Z;Z;Z;Z;Z;Z;Z;Z;Z;Z;Z;Z;Z;Z;Z;Z;Z;Z;Z;Z;Z;Z;Z;Z;Z;Z;Z;Z;Z;Z;Z;Z;Z;Z;Z;Z;Z;Z;Z;Z;Z;Z;Z;Z;Z;Z;Z;Z;Z;Z;Z;Z;Z;Z;Z;Z;Z;Z;Z;Z;Z;Z;Z;Z;Z;Z;Z;Z;Z;Z;Z;Z;Z;Z;Z;Z;Z;Z;Z;Z;Z;Z
Z;Z;Z;Z;Z;Z;Z;Z;Z;Z;Z;Z;Z;0;0;Z;Z;Z;Z;Z;Z;Z;Z;Z;Z;Z;Z;Z;Z;Z;Z;Z;Z;Z;Z;Z;Z;Z;Z;Z;Z;Z;Z;Z;Z;Z;Z;Z;Z;Z;Z;Z;Z;Z;Z;Z;Z;Z;Z;Z;Z;Z;Z;Z;Z;Z;Z;Z;Z;Z;Z;Z;Z;Z;Z;Z;Z;Z;Z;Z;Z;Z;Z;Z;Z;Z;Z;Z;Z;Z;Z;Z;Z;Z;Z;Z;Z;Z;Z;Z;Z;Z;Z;Z;Z;Z;Z;Z;Z;Z;Z;Z;Z;Z;Z;Z;Z;Z;Z;Z;Z;Z;Z;Z;Z;Z;Z;Z;Z;Z;Z;Z;Z;Z;Z;Z;Z;Z;Z;Z;Z;Z;Z;Z;Z;Z;Z;Z;Z;Z;Z;Z;Z;Z;Z;Z;Z;Z;Z;Z;Z;Z;Z;Z;Z;Z;Z;Z;Z;Z;Z;Z;Z;Z;Z;Z;Z;Z;Z;Z;Z;Z;Z;Z;Z;Z;Z;Z;Z;Z
Z;Z;Z;Z;Z;Z;Z;Z;Z;Z;Z;Z;0;0;0;0;Z;Z;Z;Z;Z;Z;Z;Z;Z;Z;Z;Z;Z;Z;Z;Z;Z;Z;Z;Z;Z;Z;Z;Z;Z;Z;Z;Z;Z;Z;Z;Z;Z;Z;Z;Z;Z;Z;Z;Z;Z;Z;Z;Z;Z;Z;Z;Z;Z;Z;Z;Z;Z;Z;Z;Z;Z;Z;Z;Z;Z;Z;Z;Z;Z;Z;Z;Z;Z;Z;Z;Z;Z;Z;Z;Z;Z;Z;Z;Z;Z;Z;Z;Z;Z;Z;Z;Z;Z;Z;Z;Z;Z;Z;Z;Z;Z;Z;Z;Z;Z;Z;Z;Z;Z;Z;Z;Z;Z;Z;Z;Z;Z;Z;Z;Z;Z;Z;Z;Z;Z;Z;Z;Z;Z;Z;Z;Z;Z;Z;Z;Z;Z;Z;Z;Z;Z;Z;Z;Z;Z;Z;Z;Z;Z;Z;Z;Z;Z;Z;Z;Z;Z;Z;Z;Z;Z;Z;Z;Z;Z;Z;Z;Z;Z;Z;Z;Z;Z;Z;Z;Z;Z;Z
Z;Z;Z;Z;Z;Z;Z;Z;Z;Z;Z;0;0;0;0;0;Z;0;Z;Z;Z;Z;Z;Z;Z;Z;Z;Z;0;Z;Z;Z;Z;Z;Z;Z;Z;Z;Z;Z;Z;Z;Z;Z;Z;Z;Z;Z;Z;Z;Z;Z;Z;Z;Z;Z;Z;Z;Z;Z;Z;Z;Z;Z;Z;Z;Z;Z;Z;Z;Z;Z;Z;Z;Z;Z;Z;Z;Z;Z;Z;Z;Z;Z;Z;Z;Z;Z;Z;Z;Z;Z;Z;Z;Z;Z;Z;Z;Z;Z;Z;Z;Z;Z;Z;Z;Z;Z;Z;Z;Z;Z;Z;Z;Z;Z;Z;Z;Z;Z;Z;Z;Z;Z;Z;Z;Z;Z;Z;Z;Z;Z;Z;Z;Z;Z;Z;Z;Z;Z;Z;Z;Z;Z;Z;Z;Z;Z;Z;Z;Z;Z;Z;Z;Z;Z;Z;Z;Z;Z;Z;Z;Z;Z;Z;Z;Z;Z;Z;Z;Z;Z;Z;Z;Z;Z;Z;Z;Z;Z;Z;Z;Z;Z;Z;Z;Z;Z;Z;Z
Z;Z;Z;Z;Z;Z;Z;Z;Z;Z;Z;Z;Z;Z;0;0;0;0;Z;Z;Z;Z;Z;Z;Z;0;Z;Z;Z;Z;Z;Z;Z;Z;Z;Z;Z;Z;Z;Z;Z;Z;Z;Z;Z;Z;Z;Z;Z;Z;Z;Z;Z;0;0;0;Z;0;0;0;0;0;0;Z;Z;Z;Z;Z;Z;Z;Z;Z;Z;Z;Z;Z;Z;Z;Z;Z;Z;Z;Z;Z;Z;Z;Z;Z;Z;Z;Z;Z;Z;Z;Z;Z;Z;Z;Z;Z;Z;Z;Z;Z;Z;Z;Z;Z;Z;Z;Z;Z;Z;Z;Z;Z;Z;Z;Z;Z;Z;Z;Z;Z;Z;Z;Z;Z;Z;Z;Z;Z;Z;Z;Z;Z;Z;Z;Z;Z;Z;Z;Z;Z;Z;Z;Z;Z;Z;Z;Z;Z;Z;Z;Z;Z;Z;Z;Z;Z;Z;Z;Z;Z;Z;Z;Z;Z;Z;Z;Z;Z;Z;Z;Z;Z;Z;Z;Z;Z;Z;Z;Z;Z;Z;Z;Z;Z;Z;Z
Z;Z;Z;Z;Z;Z;Z;Z;Z;Z;0;0;0;0;0;0;0;0;Z;Z;Z;Z;Z;Z;Z;Z;Z;Z;Z;Z;Z;Z;Z;Z;Z;Z;Z;Z;Z;Z;Z;Z;Z;Z;Z;Z;Z;Z;Z;Z;Z;Z;0;0;Z;Z;Z;Z;Z;Z;Z;Z;Z;0;0;Z;Z;Z;Z;Z;Z;Z;Z;Z;Z;Z;Z;Z;Z;Z;Z;Z;Z;Z;Z;Z;Z;Z;Z;Z;Z;Z;Z;Z;Z;Z;Z;Z;Z;Z;Z;Z;Z;Z;Z;Z;Z;Z;Z;Z;Z;Z;Z;Z;Z;Z;Z;Z;Z;Z;Z;Z;Z;Z;Z;Z;Z;Z;Z;Z;Z;Z;Z;Z;Z;Z;Z;Z;Z;Z;Z;Z;Z;Z;Z;Z;Z;Z;Z;Z;Z;Z;Z;Z;Z;Z;Z;Z;Z;Z;Z;Z;Z;Z;Z;Z;Z;Z;Z;Z;Z;Z;Z;Z;Z;Z;Z;Z;Z;Z;Z;Z;Z;Z;Z;Z;Z;Z;Z;Z
Z;Z;Z;Z;Z;Z;Z;Z;Z;Z;0;0;0;0;0;0;0;0;Z;Z;Z;Z;Z;Z;Z;Z;Z;Z;Z;Z;Z;Z;Z;Z;Z;Z;Z;Z;Z;Z;Z;Z;Z;Z;Z;Z;Z;Z;Z;Z;Z;0;0;Z;Z;Z;Z;Z;Z;Z;Z;Z;Z;Z;0;0;Z;Z;Z;Z;Z;Z;Z;Z;Z;Z;Z;Z;Z;Z;Z;Z;Z;Z;Z;Z;Z;Z;Z;Z;Z;Z;Z;Z;Z;Z;Z;Z;Z;Z;Z;Z;Z;Z;Z;Z;Z;Z;Z;Z;Z;Z;Z;Z;Z;Z;Z;Z;Z;Z;Z;Z;Z;Z;Z;Z;Z;Z;Z;Z;Z;Z;Z;Z;Z;Z;Z;Z;Z;Z;Z;Z;Z;Z;Z;Z;Z;Z;Z;Z;Z;Z;Z;Z;Z;Z;Z;Z;Z;Z;Z;Z;Z;Z;Z;Z;Z;Z;Z;Z;Z;Z;Z;Z;Z;Z;Z;Z;Z;Z;Z;Z;Z;Z;Z;Z;Z;Z;Z;Z
Z;Z;Z;Z;Z;Z;Z;Z;Z;Z;0;0;0;0;Z;Z;0;Z;Z;Z;Z;Z;Z;Z;Z;Z;Z;Z;Z;Z;0;Z;Z;Z;Z;Z;Z;Z;Z;Z;Z;Z;Z;Z;Z;Z;Z;Z;Z;Z;Z;0;Z;Z;Z;Z;Z;Z;Z;Z;Z;Z;Z;Z;Z;0;Z;Z;Z;Z;Z;Z;Z;Z;Z;Z;Z;Z;Z;Z;Z;Z;Z;Z;Z;Z;Z;Z;Z;Z;Z;Z;Z;Z;Z;Z;Z;Z;Z;Z;Z;Z;Z;Z;Z;Z;Z;Z;Z;Z;Z;Z;Z;Z;Z;Z;Z;Z;Z;Z;Z;Z;Z;Z;Z;Z;Z;Z;Z;Z;Z;Z;Z;Z;Z;Z;Z;Z;Z;Z;Z;Z;Z;Z;Z;Z;Z;Z;Z;Z;Z;Z;Z;Z;Z;Z;Z;Z;Z;Z;Z;Z;Z;Z;Z;Z;Z;Z;Z;Z;Z;Z;Z;Z;Z;Z;Z;Z;Z;Z;Z;Z;Z;Z;Z;Z;Z;Z;Z;Z
Z;Z;Z;Z;Z;Z;Z;Z;Z;0;0;0;0;0;0;Z;Z;Z;Z;Z;Z;Z;Z;Z;Z;Z;Z;Z;Z;Z;Z;Z;Z;Z;Z;Z;Z;Z;Z;Z;Z;Z;Z;Z;Z;Z;Z;Z;Z;Z;Z;0;Z;Z;Z;Z;Z;Z;Z;Z;Z;Z;Z;Z;Z;0;0;Z;Z;Z;Z;Z;Z;Z;Z;Z;Z;Z;Z;Z;Z;Z;Z;Z;Z;Z;Z;Z;Z;Z;Z;Z;Z;Z;Z;Z;Z;Z;Z;Z;Z;Z;Z;Z;Z;Z;Z;Z;Z;Z;Z;Z;Z;Z;Z;Z;Z;Z;Z;Z;Z;Z;Z;Z;Z;Z;Z;Z;Z;Z;Z;Z;Z;Z;Z;Z;Z;Z;Z;Z;Z;Z;Z;Z;Z;Z;Z;Z;Z;Z;Z;Z;Z;Z;Z;Z;Z;Z;Z;Z;Z;Z;Z;Z;Z;Z;Z;Z;Z;Z;Z;Z;Z;Z;Z;Z;Z;Z;Z;Z;Z;Z;Z;Z;Z;Z;Z;Z;Z;Z
Z;Z;Z;Z;Z;Z;Z;Z;Z;0;0;0;0;0;0;0;0;Z;Z;Z;Z;Z;Z;Z;Z;Z;Z;Z;Z;Z;Z;Z;Z;Z;Z;Z;Z;Z;Z;Z;Z;Z;Z;Z;Z;Z;Z;Z;Z;Z;0;0;Z;Z;Z;Z;Z;Z;Z;Z;Z;Z;Z;Z;Z;Z;0;Z;Z;Z;Z;Z;Z;Z;Z;Z;Z;Z;Z;Z;Z;Z;Z;Z;Z;Z;Z;Z;Z;Z;Z;Z;Z;Z;Z;Z;Z;Z;Z;Z;Z;Z;Z;Z;Z;Z;Z;Z;Z;Z;Z;Z;Z;Z;Z;Z;Z;Z;Z;Z;Z;Z;Z;Z;Z;Z;Z;Z;Z;Z;Z;Z;Z;Z;Z;Z;Z;Z;Z;Z;Z;Z;Z;Z;Z;Z;Z;Z;Z;Z;Z;Z;Z;Z;Z;Z;Z;Z;Z;Z;Z;Z;Z;Z;Z;Z;Z;Z;Z;Z;Z;Z;Z;Z;Z;Z;Z;Z;Z;Z;Z;Z;Z;Z;Z;Z;Z;Z;Z;Z
Z;Z;Z;Z;Z;Z;Z;Z;Z;Z;Z;Z;0;0;0;0;0;Z;Z;Z;Z;Z;Z;Z;Z;Z;Z;0;Z;Z;Z;Z;Z;Z;Z;Z;Z;Z;Z;Z;Z;Z;Z;Z;Z;Z;Z;Z;Z;Z;0;Z;Z;Z;Z;Z;Z;Z;Z;Z;Z;Z;Z;Z;Z;Z;Z;Z;Z;Z;Z;Z;Z;Z;Z;Z;Z;Z;Z;Z;Z;Z;Z;Z;Z;Z;Z;Z;Z;Z;Z;Z;Z;Z;Z;Z;Z;Z;Z;Z;Z;Z;Z;Z;Z;Z;Z;Z;Z;Z;Z;Z;Z;Z;Z;Z;Z;Z;Z;Z;Z;Z;Z;Z;Z;Z;Z;Z;Z;Z;Z;Z;Z;Z;Z;Z;Z;Z;Z;Z;Z;Z;Z;Z;Z;Z;Z;Z;Z;Z;Z;Z;Z;Z;Z;Z;Z;Z;Z;Z;Z;Z;Z;Z;Z;Z;Z;Z;Z;Z;Z;Z;Z;Z;Z;Z;Z;Z;Z;Z;Z;Z;Z;Z;Z;Z;Z;Z;Z;Z
Z;Z;Z;Z;Z;Z;Z;Z;Z;0;0;Z;0;0;0;0;Z;Z;Z;Z;Z;Z;Z;Z;Z;Z;Z;Z;Z;Z;Z;Z;Z;Z;Z;Z;Z;Z;Z;Z;Z;Z;Z;Z;Z;Z;Z;Z;Z;Z;0;Z;Z;Z;Z;Z;Z;Z;Z;Z;Z;Z;Z;Z;Z;Z;Z;0;Z;Z;Z;Z;Z;Z;Z;Z;Z;Z;Z;Z;Z;Z;Z;Z;Z;Z;Z;Z;Z;Z;Z;Z;Z;Z;Z;Z;Z;Z;Z;Z;Z;Z;Z;Z;Z;Z;Z;Z;Z;Z;Z;Z;Z;Z;Z;Z;Z;Z;Z;Z;Z;Z;Z;Z;Z;Z;Z;Z;Z;Z;Z;Z;Z;Z;Z;Z;Z;Z;Z;Z;Z;Z;Z;Z;Z;Z;Z;Z;Z;Z;Z;Z;Z;Z;Z;Z;Z;Z;Z;Z;Z;Z;Z;Z;Z;Z;Z;Z;Z;Z;Z;Z;Z;Z;Z;Z;Z;Z;Z;Z;Z;Z;Z;Z;Z;Z;Z;Z;Z;Z
Z;Z;Z;Z;Z;Z;Z;Z;Z;0;0;0;0;0;0;0;Z;Z;Z;Z;Z;Z;Z;Z;Z;Z;Z;Z;Z;Z;Z;Z;Z;Z;Z;Z;Z;Z;Z;Z;Z;Z;Z;Z;Z;Z;Z;Z;Z;Z;0;Z;Z;Z;Z;Z;Z;Z;Z;Z;Z;Z;Z;Z;Z;Z;Z;0;Z;Z;Z;Z;Z;Z;Z;Z;Z;Z;Z;Z;Z;Z;Z;Z;Z;Z;Z;Z;Z;Z;Z;Z;Z;Z;Z;Z;Z;Z;Z;Z;Z;Z;Z;Z;Z;Z;Z;Z;Z;Z;Z;Z;Z;Z;Z;Z;Z;Z;Z;Z;Z;Z;Z;Z;Z;Z;Z;Z;Z;Z;Z;Z;Z;Z;Z;Z;Z;Z;Z;Z;Z;Z;Z;Z;Z;Z;Z;Z;Z;Z;Z;Z;Z;Z;Z;Z;Z;Z;Z;Z;Z;Z;Z;Z;Z;Z;Z;Z;Z;Z;Z;Z;Z;Z;Z;Z;Z;Z;Z;Z;Z;Z;Z;Z;Z;Z;Z;Z;Z;Z
Z;Z;Z;Z;Z;Z;Z;Z;0;0;0;0;0;0;0;0;Z;Z;Z;Z;Z;Z;Z;Z;Z;Z;Z;Z;Z;Z;Z;Z;Z;Z;Z;Z;Z;Z;Z;Z;Z;Z;Z;Z;Z;Z;Z;Z;Z;Z;0;Z;Z;Z;Z;Z;Z;Z;Z;Z;Z;Z;Z;Z;Z;Z;Z;0;Z;Z;Z;Z;Z;Z;Z;Z;Z;Z;Z;Z;Z;Z;Z;Z;Z;Z;Z;Z;Z;Z;Z;Z;Z;Z;Z;Z;Z;Z;Z;Z;Z;Z;Z;Z;Z;Z;Z;Z;Z;Z;Z;Z;Z;Z;Z;Z;Z;Z;Z;Z;Z;Z;Z;Z;Z;Z;Z;Z;Z;Z;Z;Z;Z;Z;Z;Z;Z;Z;Z;Z;Z;Z;Z;Z;Z;Z;Z;Z;Z;Z;Z;Z;Z;Z;Z;Z;Z;Z;Z;Z;Z;Z;Z;Z;Z;Z;Z;Z;Z;Z;Z;Z;Z;Z;Z;Z;Z;Z;Z;Z;Z;Z;Z;Z;Z;Z;Z;Z;Z;Z
Z;Z;Z;Z;Z;Z;Z;Z;0;0;0;0;0;0;0;Z;Z;Z;Z;Z;Z;Z;Z;Z;Z;Z;Z;Z;Z;Z;Z;Z;Z;Z;Z;Z;Z;Z;Z;Z;Z;Z;Z;Z;Z;Z;Z;Z;Z;Z;0;Z;Z;Z;Z;Z;Z;Z;Z;Z;Z;Z;Z;Z;Z;Z;Z;0;0;Z;Z;Z;Z;Z;Z;Z;Z;Z;Z;Z;Z;Z;Z;Z;Z;Z;Z;Z;Z;Z;Z;Z;Z;Z;Z;Z;Z;Z;Z;Z;Z;Z;Z;Z;Z;Z;Z;Z;Z;Z;Z;Z;Z;Z;Z;Z;Z;Z;Z;Z;Z;Z;Z;Z;Z;Z;Z;Z;Z;Z;Z;Z;Z;Z;Z;Z;Z;Z;Z;Z;Z;Z;Z;Z;Z;Z;Z;Z;Z;Z;Z;Z;Z;Z;Z;Z;Z;Z;Z;Z;Z;Z;Z;Z;Z;Z;Z;Z;Z;Z;Z;Z;Z;Z;Z;Z;Z;Z;Z;Z;Z;Z;Z;Z;Z;Z;Z;Z;Z;Z
Z;Z;Z;Z;Z;Z;Z;Z;0;0;0;Z;Z;0;0;Z;Z;Z;Z;Z;Z;Z;Z;Z;Z;Z;Z;Z;Z;Z;Z;Z;Z;Z;Z;Z;Z;Z;Z;Z;Z;Z;Z;Z;Z;Z;Z;Z;Z;Z;0;Z;Z;Z;Z;Z;Z;Z;Z;Z;Z;Z;Z;Z;Z;Z;Z;Z;0;Z;Z;Z;Z;Z;Z;Z;Z;Z;Z;Z;Z;Z;Z;Z;Z;Z;Z;Z;Z;Z;Z;Z;Z;Z;Z;Z;Z;Z;Z;Z;Z;Z;Z;Z;Z;Z;Z;Z;Z;Z;Z;Z;Z;Z;Z;Z;Z;Z;Z;Z;Z;Z;Z;Z;Z;Z;Z;Z;Z;Z;Z;Z;Z;Z;Z;Z;Z;Z;Z;Z;Z;Z;Z;Z;Z;Z;Z;Z;Z;Z;Z;Z;Z;Z;Z;Z;Z;Z;Z;Z;Z;Z;Z;Z;Z;Z;Z;Z;Z;Z;Z;Z;Z;Z;Z;Z;Z;Z;Z;Z;Z;Z;Z;Z;Z;Z;Z;Z;Z;Z
Z;Z;Z;Z;Z;Z;Z;Z;0;0;0;0;Z;Z;Z;Z;Z;Z;Z;Z;Z;Z;Z;Z;Z;Z;Z;Z;Z;Z;Z;Z;Z;Z;Z;Z;Z;Z;Z;Z;Z;Z;Z;Z;Z;Z;Z;Z;Z;0;0;Z;Z;Z;Z;Z;Z;Z;Z;Z;Z;Z;Z;Z;Z;Z;Z;Z;0;Z;Z;Z;Z;Z;Z;Z;Z;Z;Z;Z;Z;Z;Z;Z;Z;Z;Z;Z;Z;Z;Z;Z;Z;Z;Z;Z;Z;Z;Z;Z;Z;Z;Z;Z;Z;Z;Z;Z;Z;Z;Z;Z;Z;Z;Z;Z;Z;Z;Z;Z;Z;Z;Z;Z;Z;Z;Z;Z;Z;Z;Z;Z;Z;Z;Z;Z;0;Z;Z;Z;Z;0;Z;Z;Z;Z;Z;Z;Z;Z;Z;Z;Z;Z;Z;Z;Z;Z;Z;Z;Z;Z;Z;Z;Z;Z;Z;Z;Z;Z;Z;Z;Z;Z;Z;Z;Z;Z;Z;Z;Z;Z;Z;Z;Z;Z;Z;Z;Z;Z
Z;Z;Z;Z;Z;Z;Z;Z;Z;0;0;0;0;0;0;0;Z;Z;Z;Z;Z;Z;Z;Z;Z;Z;Z;Z;Z;Z;Z;Z;Z;Z;Z;Z;Z;Z;Z;Z;Z;Z;Z;Z;Z;Z;Z;Z;Z;0;Z;Z;Z;Z;Z;Z;Z;Z;Z;Z;Z;Z;Z;Z;Z;Z;Z;Z;0;0;Z;Z;Z;Z;Z;Z;Z;Z;Z;Z;Z;Z;Z;Z;Z;Z;Z;Z;Z;Z;Z;Z;Z;Z;Z;Z;Z;Z;Z;Z;Z;Z;Z;Z;Z;Z;Z;Z;Z;Z;Z;Z;Z;Z;Z;Z;Z;Z;Z;Z;Z;Z;Z;Z;Z;Z;Z;Z;Z;Z;Z;Z;Z;Z;Z;Z;Z;Z;Z;Z;Z;Z;Z;Z;Z;Z;Z;Z;Z;Z;Z;Z;Z;Z;Z;Z;Z;Z;Z;Z;Z;Z;Z;Z;Z;Z;Z;Z;Z;Z;Z;Z;Z;Z;Z;Z;Z;Z;Z;Z;Z;Z;Z;Z;Z;Z;Z;Z;Z;Z
Z;Z;Z;Z;Z;Z;Z;Z;Z;0;0;Z;0;0;0;0;Z;Z;Z;Z;Z;Z;Z;Z;Z;Z;0;Z;Z;Z;Z;Z;Z;Z;Z;Z;Z;Z;Z;Z;Z;Z;Z;Z;Z;Z;Z;Z;Z;0;Z;Z;Z;Z;Z;Z;Z;Z;Z;Z;Z;Z;Z;Z;Z;Z;Z;Z;Z;0;Z;Z;Z;Z;Z;Z;Z;Z;Z;Z;Z;Z;Z;Z;Z;Z;Z;Z;Z;Z;Z;Z;Z;Z;Z;Z;Z;Z;Z;Z;Z;Z;Z;Z;Z;Z;Z;Z;Z;Z;Z;Z;Z;Z;Z;Z;Z;Z;Z;Z;Z;Z;Z;Z;Z;Z;Z;Z;Z;Z;Z;Z;Z;Z;Z;Z;Z;Z;Z;Z;Z;Z;Z;Z;Z;Z;Z;Z;Z;Z;Z;Z;Z;Z;Z;Z;Z;Z;Z;Z;Z;Z;Z;Z;Z;Z;Z;Z;Z;Z;Z;Z;Z;Z;Z;Z;Z;Z;Z;Z;Z;Z;Z;Z;Z;Z;Z;Z;Z;Z
Z;Z;Z;Z;Z;Z;Z;Z;Z;Z;Z;Z;0;0;0;Z;Z;Z;Z;Z;Z;Z;Z;Z;Z;Z;Z;Z;Z;Z;Z;Z;Z;Z;Z;Z;Z;Z;Z;Z;Z;Z;Z;Z;Z;Z;Z;Z;0;0;Z;Z;Z;Z;Z;Z;Z;Z;Z;Z;Z;Z;Z;Z;Z;Z;Z;Z;Z;0;0;Z;Z;Z;Z;Z;Z;Z;Z;Z;Z;Z;Z;Z;Z;Z;Z;Z;Z;Z;Z;Z;Z;Z;Z;Z;Z;Z;Z;Z;Z;Z;Z;Z;Z;Z;Z;Z;Z;Z;Z;Z;Z;Z;Z;Z;Z;Z;Z;Z;Z;Z;Z;Z;Z;Z;Z;Z;Z;Z;Z;Z;Z;Z;Z;Z;Z;Z;Z;Z;Z;Z;Z;Z;Z;Z;0;Z;Z;Z;Z;Z;Z;Z;Z;Z;Z;Z;Z;Z;Z;Z;Z;Z;Z;Z;Z;Z;Z;Z;Z;Z;Z;Z;Z;Z;Z;Z;Z;Z;Z;Z;Z;Z;Z;Z;Z;Z;Z;Z
Z;Z;Z;Z;Z;Z;Z;Z;Z;Z;0;0;0;0;0;Z;0;0;0;Z;Z;Z;Z;Z;Z;Z;Z;Z;Z;Z;Z;Z;Z;Z;Z;Z;Z;Z;Z;Z;Z;Z;Z;Z;Z;Z;Z;Z;Z;Z;Z;Z;Z;Z;Z;Z;Z;Z;Z;Z;Z;Z;Z;Z;Z;Z;Z;Z;Z;Z;0;Z;Z;Z;Z;Z;Z;Z;Z;Z;Z;Z;Z;Z;Z;Z;Z;Z;Z;Z;Z;Z;Z;Z;Z;Z;Z;Z;Z;Z;Z;Z;Z;Z;Z;Z;Z;Z;Z;Z;Z;Z;Z;Z;Z;Z;Z;Z;Z;Z;Z;Z;Z;Z;Z;Z;Z;Z;Z;Z;Z;Z;0;Z;Z;Z;Z;Z;Z;Z;Z;Z;Z;Z;Z;Z;Z;Z;Z;Z;Z;Z;Z;Z;Z;Z;Z;Z;Z;Z;Z;Z;Z;Z;Z;Z;Z;Z;Z;Z;Z;Z;Z;Z;Z;Z;Z;Z;Z;Z;Z;Z;Z;Z;Z;Z;Z;Z;Z;Z
Z;Z;Z;Z;Z;Z;Z;Z;Z;0;0;0;0;0;0;0;0;0;0;0;Z;Z;Z;Z;Z;Z;Z;Z;Z;Z;Z;Z;Z;Z;Z;Z;Z;Z;Z;Z;Z;Z;Z;Z;Z;Z;Z;0;0;Z;Z;Z;Z;Z;Z;Z;Z;Z;Z;Z;Z;Z;Z;Z;Z;Z;Z;Z;Z;Z;0;0;Z;Z;Z;Z;Z;Z;Z;Z;Z;Z;Z;Z;Z;Z;Z;Z;Z;Z;Z;Z;Z;Z;Z;Z;Z;Z;Z;Z;Z;Z;Z;Z;Z;Z;Z;Z;Z;Z;Z;Z;Z;Z;Z;Z;Z;Z;Z;Z;Z;Z;Z;Z;Z;Z;Z;Z;Z;Z;Z;Z;Z;Z;Z;Z;Z;0;Z;Z;Z;Z;Z;Z;Z;Z;Z;Z;Z;Z;Z;Z;Z;Z;Z;Z;Z;Z;Z;Z;Z;Z;Z;Z;Z;Z;Z;Z;Z;Z;Z;Z;Z;Z;Z;Z;Z;Z;Z;Z;Z;Z;Z;Z;Z;Z;Z;Z;Z;Z
Z;Z;Z;Z;Z;Z;Z;Z;Z;0;0;0;0;0;0;0;0;0;0;0;0;Z;Z;Z;Z;Z;Z;Z;Z;Z;Z;Z;Z;Z;Z;Z;Z;Z;Z;Z;Z;Z;Z;Z;Z;Z;0;0;Z;Z;Z;Z;Z;Z;Z;Z;Z;Z;Z;Z;Z;Z;Z;Z;Z;Z;Z;Z;Z;Z;Z;0;Z;Z;Z;Z;Z;Z;Z;Z;Z;Z;Z;Z;Z;Z;Z;Z;Z;Z;Z;Z;Z;Z;Z;Z;Z;Z;Z;Z;Z;Z;Z;Z;Z;Z;Z;Z;Z;Z;Z;Z;Z;Z;Z;Z;Z;Z;Z;Z;Z;Z;Z;Z;Z;Z;Z;Z;Z;Z;Z;Z;Z;Z;Z;Z;Z;Z;Z;Z;Z;Z;Z;Z;Z;Z;Z;Z;Z;Z;Z;Z;Z;Z;Z;Z;Z;Z;Z;Z;Z;Z;Z;Z;Z;Z;Z;Z;Z;Z;Z;Z;Z;Z;Z;Z;Z;Z;Z;Z;Z;Z;Z;Z;Z;Z;Z;Z;Z;Z
Z;Z;Z;Z;Z;Z;Z;Z;Z;0;0;0;0;0;0;0;0;0;0;0;0;Z;Z;0;Z;Z;Z;Z;Z;Z;Z;Z;Z;Z;Z;Z;Z;Z;Z;Z;Z;Z;Z;Z;Z;0;0;Z;Z;Z;Z;Z;Z;Z;Z;Z;Z;Z;Z;Z;Z;Z;Z;Z;Z;Z;Z;Z;Z;Z;Z;0;Z;Z;Z;Z;Z;Z;Z;Z;Z;Z;Z;Z;Z;Z;Z;Z;Z;Z;Z;Z;Z;Z;Z;Z;Z;Z;Z;Z;Z;Z;Z;Z;Z;Z;Z;Z;Z;Z;Z;Z;Z;Z;Z;Z;Z;Z;Z;Z;Z;Z;Z;Z;Z;Z;Z;Z;Z;Z;Z;Z;Z;Z;Z;Z;Z;Z;Z;Z;Z;0;0;0;0;Z;Z;Z;Z;Z;Z;Z;Z;Z;Z;Z;Z;Z;Z;Z;Z;Z;Z;Z;Z;Z;Z;Z;Z;Z;Z;Z;Z;Z;Z;Z;Z;Z;Z;Z;Z;Z;Z;Z;Z;Z;Z;Z;Z;Z
Z;Z;Z;Z;Z;Z;Z;Z;Z;Z;Z;0;0;0;0;0;0;0;0;0;0;Z;0;0;0;0;0;0;Z;Z;Z;Z;Z;Z;Z;Z;Z;Z;Z;Z;Z;Z;Z;Z;Z;0;Z;Z;Z;Z;Z;Z;Z;Z;Z;Z;Z;Z;Z;Z;Z;Z;Z;Z;Z;Z;Z;Z;Z;Z;Z;0;Z;Z;Z;Z;Z;Z;Z;Z;Z;Z;Z;0;0;0;Z;0;0;Z;Z;Z;Z;Z;Z;Z;Z;Z;Z;Z;Z;Z;Z;Z;Z;Z;Z;Z;Z;Z;Z;Z;Z;Z;Z;Z;Z;Z;Z;Z;Z;Z;Z;Z;Z;Z;Z;Z;Z;Z;Z;Z;Z;Z;Z;0;0;0;0;Z;0;0;0;0;0;0;0;0;0;Z;Z;Z;Z;Z;Z;Z;Z;Z;Z;Z;Z;Z;Z;Z;Z;Z;Z;Z;Z;Z;Z;Z;Z;Z;Z;Z;Z;Z;Z;0;Z;Z;Z;Z;Z;Z;Z;Z;Z;Z
Z;Z;Z;Z;Z;Z;Z;Z;Z;Z;Z;Z;0;0;0;0;Z;0;0;0;0;Z;0;0;0;0;0;0;0;0;Z;0;Z;Z;Z;Z;Z;Z;Z;Z;Z;Z;0;0;0;Z;Z;Z;Z;Z;Z;Z;Z;Z;Z;Z;Z;Z;Z;Z;Z;Z;Z;Z;Z;Z;Z;Z;Z;Z;Z;0;Z;Z;Z;Z;Z;Z;Z;Z;Z;Z;0;0;Z;Z;Z;Z;0;0;0;0;Z;Z;Z;Z;Z;Z;Z;Z;Z;Z;Z;Z;Z;Z;Z;Z;Z;Z;Z;Z;Z;Z;Z;Z;Z;Z;Z;Z;Z;Z;Z;Z;Z;Z;Z;Z;Z;Z;0;0;0;0;0;0;0;0;Z;0;0;0;0;0;0;0;0;0;0;0;Z;0;Z;Z;Z;Z;Z;Z;Z;Z;Z;Z;Z;Z;Z;Z;Z;Z;Z;Z;Z;Z;Z;Z;Z;Z;Z;Z;Z;Z;Z;Z;Z;Z;0;Z;Z;Z;Z;Z
Z;Z;Z;Z;Z;Z;Z;Z;Z;Z;Z;Z;Z;Z;0;Z;Z;0;0;0;0;0;0;0;0;0;0;0;0;0;Z;0;0;0;Z;Z;Z;Z;Z;Z;0;0;0;Z;Z;Z;Z;Z;Z;Z;Z;Z;Z;Z;Z;Z;Z;Z;Z;Z;Z;Z;Z;Z;Z;Z;Z;Z;Z;Z;Z;Z;Z;Z;Z;Z;Z;Z;Z;Z;Z;0;0;Z;Z;Z;Z;Z;Z;Z;Z;0;0;Z;Z;Z;Z;Z;Z;Z;Z;Z;Z;Z;Z;Z;Z;Z;Z;Z;Z;Z;Z;Z;Z;Z;Z;Z;Z;Z;Z;Z;Z;Z;Z;Z;Z;0;0;Z;0;0;0;0;0;0;0;Z;Z;0;0;0;0;0;0;0;0;0;0;0;Z;0;0;0;0;0;0;0;0;0;0;0;Z;Z;Z;Z;Z;Z;Z;Z;Z;Z;Z;Z;Z;Z;Z;Z;Z;Z;Z;Z;Z;Z;Z;Z;Z;Z;Z;Z
Z;Z;Z;Z;Z;Z;Z;Z;Z;Z;Z;Z;Z;Z;Z;Z;0;0;0;0;0;0;0;0;Z;0;0;0;0;0;Z;0;0;0;0;Z;0;0;0;0;0;Z;Z;Z;Z;Z;Z;Z;Z;Z;Z;Z;Z;Z;Z;Z;Z;Z;Z;Z;Z;Z;Z;Z;Z;Z;Z;Z;Z;Z;Z;0;Z;Z;Z;Z;Z;Z;Z;Z;0;0;Z;Z;Z;Z;Z;Z;Z;Z;Z;Z;0;0;Z;Z;Z;Z;Z;Z;Z;Z;Z;Z;Z;Z;Z;Z;Z;Z;Z;Z;Z;Z;Z;Z;Z;Z;Z;Z;Z;Z;Z;Z;Z;0;0;0;Z;Z;0;0;0;0;0;0;Z;Z;0;0;0;0;0;0;0;0;0;0;0;0;Z;Z;0;0;0;0;0;0;0;0;0;0;0;0;0;Z;0;0;0;0;0;0;0;Z;Z;Z;Z;Z;Z;Z;Z;Z;Z;Z;Z;Z;Z;Z;Z;Z
Z;Z;Z;Z;Z;Z;Z;Z;Z;Z;Z;Z;Z;Z;Z;Z;Z;Z;Z;0;0;0;0;0;Z;0;0;0;0;0;0;0;0;0;0;0;0;0;Z;Z;Z;Z;Z;Z;Z;Z;Z;Z;Z;Z;Z;Z;Z;Z;Z;Z;Z;Z;Z;Z;Z;Z;Z;Z;Z;Z;Z;Z;Z;Z;Z;0;Z;Z;Z;Z;Z;Z;Z;Z;0;Z;Z;Z;Z;Z;Z;Z;Z;Z;Z;Z;Z;0;Z;Z;Z;Z;Z;Z;Z;Z;Z;Z;Z;Z;Z;Z;Z;Z;Z;Z;Z;Z;Z;Z;Z;Z;Z;Z;Z;Z;Z;0;0;0;Z;Z;Z;Z;0;0;0;0;0;Z;Z;0;0;0;0;0;0;0;0;0;0;0;0;0;0;Z;Z;0;0;0;0;0;0;0;0;0;0;0;0;Z;0;0;0;0;0;0;0;0;Z;Z;Z;Z;Z;Z;Z;Z;Z;Z;Z;Z;Z;Z;Z;Z
Z;Z;Z;Z;Z;Z;Z;Z;Z;Z;Z;Z;Z;Z;Z;Z;Z;Z;Z;Z;Z;Z;Z;Z;Z;Z;0;0;0;0;0;0;0;0;0;0;Z;Z;Z;Z;Z;Z;Z;Z;Z;Z;Z;Z;Z;Z;Z;Z;Z;Z;Z;Z;Z;Z;Z;Z;Z;Z;Z;Z;Z;Z;Z;Z;Z;Z;0;0;Z;Z;Z;Z;Z;Z;Z;Z;0;Z;Z;Z;Z;Z;Z;Z;Z;Z;Z;Z;Z;0;Z;Z;Z;Z;Z;Z;Z;Z;Z;Z;Z;0;0;0;Z;Z;Z;Z;Z;Z;Z;Z;Z;Z;Z;0;0;0;0;0;Z;Z;Z;Z;Z;Z;Z;Z;Z;0;0;Z;0;0;0;0;0;0;0;0;0;0;0;0;0;0;0;0;Z;0;0;0;0;0;0;0;0;0;0;0;Z;Z;0;0;0;0;0;0;0;0;Z;Z;Z;0;Z;Z;Z;Z;Z;Z;Z;Z;Z;Z;Z;Z
Z;Z;Z;Z;Z;Z;Z;Z;Z;Z;Z;Z;Z;Z;Z;Z;Z;Z;Z;Z;Z;Z;Z;Z;Z;Z;Z;Z;0;0;0;0;0;0;Z;Z;Z;Z;Z;Z;Z;Z;Z;Z;Z;Z;Z;Z;Z;Z;Z;Z;Z;Z;Z;Z;Z;Z;Z;Z;Z;Z;Z;Z;Z;Z;Z;Z;Z;Z;0;Z;Z;Z;Z;Z;Z;Z;Z;Z;0;Z;Z;Z;Z;Z;Z;Z;Z;Z;Z;Z;Z;0;Z;Z;Z;Z;Z;Z;Z;Z;Z;0;0;0;Z;0;0;Z;Z;Z;Z;Z;Z;Z;Z;0;0;0;Z;Z;Z;Z;Z;Z;Z;Z;Z;Z;Z;Z;Z;Z;Z;Z;Z;0;0;0;0;0;0;0;0;0;0;0;0;0;0;0;Z;0;0;0;0;0;0;0;0;0;0;0;Z;0;0;0;0;0;0;0;0;0;Z;Z;Z;Z;Z;Z;Z;Z;Z;Z;Z;Z;Z;Z;Z;Z
Z;Z;Z;Z;Z;Z;Z;Z;Z;Z;Z;Z;Z;Z;Z;Z;Z;Z;Z;Z;Z;Z;Z;Z;Z;Z;Z;Z;Z;Z;Z;Z;Z;Z;Z;Z;Z;Z;Z;Z;Z;Z;Z;Z;Z;Z;Z;Z;Z;Z;Z;Z;Z;Z;Z;Z;Z;Z;Z;Z;Z;Z;Z;Z;Z;Z;Z;Z;Z;0;0;Z;Z;Z;Z;Z;Z;Z;Z;Z;0;Z;Z;Z;Z;Z;Z;Z;Z;Z;Z;Z;0;0;Z;Z;Z;Z;Z;Z;Z;Z;Z;0;Z;Z;Z;Z;0;0;Z;Z;Z;Z;Z;0;Z;Z;Z;Z;Z;Z;Z;Z;Z;Z;Z;Z;Z;Z;Z;Z;Z;Z;Z;Z;Z;Z;Z;Z;Z;Z;Z;Z;0;0;0;0;0;0;0;0;Z;0;0;0;0;0;0;0;0;0;0;Z;Z;0;0;0;0;0;0;0;0;0;Z;Z;Z;Z;Z;Z;Z;Z;Z;Z;Z;Z;Z;Z;Z;Z
Z;Z;Z;Z;Z;Z;Z;Z;Z;Z;Z;Z;Z;Z;Z;Z;Z;Z;Z;Z;Z;Z;Z;Z;Z;Z;Z;Z;Z;Z;Z;Z;Z;Z;Z;Z;Z;Z;Z;Z;Z;Z;Z;Z;Z;Z;Z;Z;Z;Z;Z;Z;Z;Z;Z;Z;Z;Z;Z;Z;Z;Z;Z;Z;Z;Z;Z;Z;Z;0;Z;Z;Z;Z;Z;Z;Z;Z;Z;Z;0;Z;Z;Z;Z;Z;Z;Z;Z;Z;Z;Z;0;Z;Z;Z;Z;Z;Z;Z;Z;Z;Z;0;Z;Z;Z;Z;Z;0;Z;Z;Z;Z;0;0;Z;Z;Z;Z;Z;Z;Z;Z;Z;Z;Z;Z;Z;Z;Z;Z;Z;Z;Z;Z;Z;Z;Z;Z;Z;Z;Z;Z;Z;Z;Z;0;0;0;0;0;Z;Z;0;0;0;0;0;0;0;0;Z;Z;0;0;0;0;0;0;0;0;0;Z;Z;Z;Z;Z;Z;Z;Z;Z;Z;Z;Z;Z;Z;Z;Z;Z
Z;Z;Z;Z;Z;Z;Z;Z;Z;Z;Z;Z;Z;Z;Z;Z;Z;Z;Z;Z;Z;Z;Z;Z;Z;Z;Z;Z;Z;Z;Z;Z;Z;Z;Z;Z;Z;Z;Z;Z;Z;Z;Z;Z;Z;Z;Z;Z;Z;Z;Z;Z;Z;Z;Z;Z;Z;Z;Z;Z;Z;Z;Z;Z;Z;Z;Z;Z;0;0;Z;Z;Z;Z;Z;Z;Z;Z;Z;Z;0;Z;Z;Z;Z;Z;Z;Z;Z;Z;Z;Z;0;Z;Z;Z;Z;Z;Z;Z;Z;Z;Z;0;Z;Z;Z;Z;Z;0;Z;Z;Z;0;0;Z;Z;Z;Z;Z;Z;Z;Z;Z;Z;Z;Z;Z;Z;Z;Z;Z;Z;Z;Z;Z;Z;Z;Z;Z;Z;Z;Z;Z;Z;Z;Z;Z;Z;Z;Z;0;0;Z;Z;0;0;0;0;0;0;0;Z;0;0;0;0;0;0;0;0;Z;Z;Z;Z;Z;Z;Z;Z;Z;Z;Z;Z;Z;Z;Z;Z;Z;Z;Z
Z;Z;Z;Z;Z;Z;Z;Z;Z;Z;Z;Z;Z;Z;Z;Z;Z;Z;Z;Z;Z;Z;Z;Z;Z;Z;Z;Z;Z;Z;Z;Z;Z;Z;Z;Z;Z;Z;Z;Z;Z;Z;Z;Z;Z;Z;Z;Z;Z;Z;Z;Z;Z;Z;Z;Z;Z;Z;Z;Z;Z;Z;Z;Z;Z;Z;Z;Z;0;Z;Z;Z;Z;Z;Z;Z;Z;Z;Z;Z;0;Z;Z;Z;Z;Z;Z;Z;Z;Z;0;Z;Z;Z;Z;Z;Z;Z;Z;Z;Z;Z;Z;0;Z;Z;Z;Z;Z;0;0;Z;0;0;Z;Z;Z;Z;Z;Z;Z;Z;Z;Z;Z;Z;Z;Z;Z;Z;Z;Z;Z;Z;Z;Z;Z;Z;Z;Z;Z;Z;Z;Z;Z;Z;Z;Z;Z;Z;Z;Z;Z;Z;Z;Z;Z;Z;Z;Z;Z;Z;Z;Z;Z;Z;Z;Z;Z;Z;Z;Z;Z;Z;0;Z;Z;Z;Z;Z;Z;Z;Z;Z;Z;Z;Z;Z;Z;Z
Z;Z;Z;Z;Z;Z;Z;Z;Z;Z;Z;Z;Z;Z;Z;Z;Z;Z;Z;Z;Z;Z;Z;Z;Z;Z;Z;Z;Z;Z;Z;Z;Z;Z;Z;Z;Z;Z;Z;Z;Z;Z;Z;Z;Z;Z;Z;Z;Z;Z;Z;Z;Z;Z;Z;Z;Z;Z;Z;Z;Z;Z;Z;Z;Z;Z;Z;0;0;Z;Z;Z;Z;Z;Z;Z;Z;Z;Z;0;0;Z;Z;Z;Z;Z;Z;Z;Z;Z;0;Z;Z;Z;Z;Z;Z;Z;Z;Z;Z;Z;Z;Z;Z;Z;Z;Z;Z;Z;0;0;0;Z;Z;Z;Z;Z;Z;Z;Z;Z;Z;Z;Z;Z;Z;Z;Z;Z;Z;Z;Z;Z;Z;Z;Z;Z;Z;Z;Z;Z;Z;Z;Z;Z;Z;Z;Z;Z;Z;Z;Z;Z;Z;Z;Z;Z;Z;Z;Z;Z;Z;Z;Z;Z;Z;Z;Z;Z;Z;Z;Z;Z;Z;Z;Z;Z;Z;Z;Z;Z;Z;Z;Z;Z;Z;Z;Z;Z
Z;Z;Z;Z;Z;Z;Z;Z;Z;Z;Z;Z;Z;Z;Z;Z;Z;Z;Z;Z;Z;Z;Z;Z;Z;Z;Z;Z;Z;Z;Z;Z;Z;Z;Z;Z;Z;Z;Z;Z;Z;Z;Z;Z;Z;Z;Z;Z;Z;Z;Z;Z;Z;Z;Z;Z;Z;Z;Z;Z;Z;Z;Z;Z;Z;Z;Z;Z;Z;Z;Z;Z;Z;Z;Z;Z;Z;Z;Z;0;Z;Z;Z;Z;Z;Z;Z;Z;Z;0;0;Z;Z;Z;Z;Z;Z;Z;Z;Z;Z;Z;0;Z;Z;Z;Z;Z;Z;Z;Z;Z;Z;Z;Z;Z;Z;Z;Z;Z;Z;Z;Z;Z;Z;Z;Z;Z;Z;Z;Z;Z;Z;Z;Z;Z;Z;Z;Z;Z;Z;Z;Z;Z;Z;Z;Z;Z;Z;Z;Z;Z;Z;Z;Z;Z;Z;Z;Z;Z;Z;Z;Z;Z;Z;Z;Z;Z;Z;Z;Z;Z;Z;Z;Z;Z;Z;Z;Z;Z;Z;Z;Z;Z;Z;Z;Z;Z;Z;Z
Z;Z;Z;Z;Z;Z;Z;Z;Z;Z;Z;Z;Z;Z;Z;Z;Z;Z;Z;Z;Z;Z;Z;Z;Z;Z;Z;Z;Z;Z;Z;Z;Z;Z;Z;Z;Z;Z;Z;Z;Z;Z;Z;Z;Z;Z;Z;Z;Z;Z;Z;Z;Z;Z;Z;Z;Z;Z;Z;Z;Z;Z;Z;Z;Z;Z;Z;0;Z;Z;Z;Z;Z;Z;Z;Z;Z;Z;0;0;Z;Z;Z;Z;Z;Z;Z;Z;0;0;Z;Z;Z;Z;Z;Z;Z;Z;Z;Z;Z;Z;0;Z;Z;Z;Z;Z;Z;Z;Z;Z;Z;Z;Z;Z;Z;Z;Z;Z;Z;Z;Z;Z;Z;Z;Z;Z;Z;Z;Z;Z;Z;Z;Z;Z;Z;Z;Z;Z;Z;Z;Z;Z;Z;Z;Z;Z;Z;Z;Z;Z;Z;Z;Z;Z;Z;Z;Z;Z;Z;Z;Z;Z;Z;Z;Z;Z;Z;Z;Z;Z;Z;Z;Z;Z;Z;Z;Z;Z;Z;Z;Z;Z;Z;Z;Z;Z;Z;Z
Z;Z;Z;Z;Z;Z;Z;Z;Z;Z;Z;Z;Z;Z;Z;Z;Z;Z;Z;Z;Z;Z;Z;Z;Z;Z;Z;Z;Z;Z;Z;Z;Z;Z;Z;Z;Z;Z;Z;Z;Z;Z;Z;Z;Z;Z;Z;Z;Z;Z;Z;Z;Z;Z;Z;Z;Z;Z;Z;Z;Z;Z;Z;Z;Z;Z;Z;0;Z;Z;Z;Z;Z;Z;Z;Z;Z;Z;Z;Z;Z;Z;Z;Z;Z;Z;Z;Z;0;Z;Z;Z;Z;Z;Z;Z;Z;Z;Z;Z;Z;0;0;Z;Z;Z;Z;Z;Z;Z;Z;Z;Z;Z;Z;Z;Z;Z;Z;Z;Z;Z;Z;Z;Z;Z;Z;Z;Z;Z;Z;Z;Z;Z;Z;Z;Z;Z;Z;Z;Z;Z;Z;Z;Z;Z;Z;Z;Z;Z;Z;Z;Z;Z;Z;Z;Z;Z;Z;Z;Z;Z;Z;Z;Z;Z;Z;Z;Z;Z;Z;Z;Z;Z;Z;Z;Z;Z;Z;Z;Z;Z;Z;Z;Z;Z;Z;Z;Z;Z
Z;Z;Z;Z;Z;Z;Z;Z;Z;Z;Z;Z;Z;Z;Z;Z;Z;Z;Z;Z;Z;Z;Z;Z;Z;Z;Z;Z;Z;Z;Z;Z;Z;Z;Z;Z;Z;Z;Z;Z;Z;Z;Z;Z;Z;Z;Z;Z;Z;Z;Z;Z;Z;Z;Z;Z;Z;Z;Z;Z;Z;Z;Z;Z;Z;Z;Z;0;Z;Z;Z;Z;Z;Z;Z;Z;Z;0;0;Z;Z;Z;Z;Z;Z;Z;Z;Z;0;Z;Z;Z;Z;Z;Z;Z;Z;Z;Z;Z;0;0;Z;Z;Z;Z;Z;Z;Z;Z;Z;Z;Z;Z;Z;Z;Z;Z;Z;Z;Z;Z;Z;Z;Z;Z;Z;Z;Z;Z;Z;Z;Z;Z;Z;Z;Z;Z;Z;Z;Z;Z;Z;Z;Z;Z;Z;Z;Z;Z;Z;Z;Z;Z;Z;Z;Z;Z;Z;Z;Z;Z;Z;Z;Z;Z;Z;Z;Z;Z;Z;Z;Z;Z;Z;Z;Z;Z;Z;Z;Z;Z;Z;Z;Z;Z;Z;Z;Z;Z
Z;Z;Z;Z;Z;Z;Z;Z;Z;Z;Z;Z;Z;Z;Z;Z;Z;Z;Z;Z;Z;Z;Z;Z;Z;Z;Z;Z;Z;Z;Z;Z;Z;Z;Z;Z;Z;Z;Z;Z;Z;Z;Z;Z;Z;Z;Z;Z;Z;Z;Z;Z;Z;Z;Z;Z;Z;Z;Z;Z;Z;Z;Z;Z;Z;Z;Z;0;Z;Z;Z;Z;Z;Z;Z;Z;Z;0;Z;Z;Z;Z;Z;Z;Z;Z;Z;Z;0;Z;Z;Z;Z;Z;Z;Z;Z;Z;Z;Z;0;Z;Z;Z;Z;Z;Z;Z;Z;Z;Z;Z;Z;Z;Z;Z;Z;Z;Z;Z;Z;Z;Z;Z;Z;Z;Z;Z;Z;Z;Z;Z;Z;Z;Z;Z;Z;Z;Z;Z;Z;Z;Z;Z;Z;Z;Z;Z;Z;Z;Z;Z;Z;Z;Z;Z;Z;Z;Z;Z;Z;Z;Z;Z;Z;Z;Z;Z;Z;Z;Z;Z;Z;Z;Z;Z;Z;Z;Z;Z;Z;Z;Z;Z;Z;Z;Z;Z;Z;Z
Z;Z;Z;Z;Z;Z;Z;Z;Z;Z;Z;Z;Z;Z;Z;Z;Z;Z;Z;Z;Z;Z;Z;Z;Z;Z;Z;Z;Z;Z;Z;Z;Z;Z;Z;Z;Z;Z;Z;Z;Z;Z;Z;Z;Z;Z;Z;Z;Z;Z;Z;Z;Z;Z;Z;Z;Z;Z;Z;Z;Z;Z;Z;Z;Z;Z;Z;0;Z;Z;Z;Z;Z;Z;Z;Z;0;0;Z;Z;Z;Z;Z;Z;Z;Z;Z;Z;0;0;0;0;Z;Z;Z;Z;Z;Z;Z;0;0;Z;Z;Z;Z;Z;Z;Z;Z;Z;Z;Z;Z;Z;Z;Z;Z;Z;Z;Z;Z;Z;Z;Z;Z;Z;Z;Z;Z;Z;Z;Z;Z;Z;Z;Z;Z;Z;Z;Z;Z;Z;Z;Z;Z;Z;Z;Z;Z;Z;Z;Z;Z;Z;Z;Z;Z;Z;Z;Z;Z;Z;Z;Z;Z;Z;Z;Z;Z;Z;Z;Z;Z;Z;Z;Z;Z;Z;Z;Z;Z;Z;Z;Z;Z;Z;Z;Z;Z;Z
Z;Z;Z;Z;Z;Z;Z;Z;Z;Z;Z;Z;Z;Z;Z;Z;Z;Z;Z;Z;Z;Z;Z;Z;Z;Z;Z;Z;Z;Z;Z;Z;Z;Z;Z;Z;Z;Z;Z;Z;Z;Z;Z;Z;Z;Z;Z;Z;Z;Z;Z;Z;Z;Z;Z;Z;Z;Z;Z;Z;Z;Z;Z;Z;Z;Z;Z;0;Z;Z;Z;Z;Z;Z;0;0;0;Z;Z;Z;Z;Z;Z;Z;Z;Z;Z;Z;Z;Z;Z;0;0;0;Z;0;0;0;0;0;Z;Z;Z;Z;Z;Z;Z;Z;Z;Z;Z;Z;Z;Z;Z;Z;Z;Z;Z;Z;Z;Z;Z;Z;Z;Z;Z;Z;Z;Z;Z;Z;Z;Z;Z;Z;Z;Z;Z;Z;Z;Z;Z;Z;Z;Z;Z;Z;Z;Z;Z;Z;Z;Z;Z;Z;Z;Z;Z;Z;Z;Z;Z;Z;Z;Z;Z;Z;Z;Z;Z;Z;Z;Z;Z;Z;Z;Z;Z;Z;Z;Z;Z;Z;Z;Z;Z;Z;Z;Z
Z;Z;Z;Z;Z;Z;Z;Z;Z;Z;Z;Z;Z;Z;Z;Z;Z;Z;Z;Z;Z;Z;Z;Z;Z;Z;Z;Z;Z;Z;Z;Z;Z;Z;Z;Z;Z;Z;Z;Z;Z;Z;Z;Z;Z;Z;Z;Z;Z;Z;Z;Z;Z;Z;Z;Z;Z;Z;Z;Z;Z;Z;Z;Z;Z;Z;Z;0;Z;Z;Z;Z;0;0;0;Z;Z;Z;Z;Z;Z;Z;Z;Z;Z;Z;Z;Z;Z;Z;Z;Z;Z;Z;Z;Z;Z;Z;Z;Z;Z;Z;Z;Z;Z;Z;Z;Z;Z;Z;Z;Z;Z;Z;Z;Z;Z;Z;Z;Z;Z;Z;Z;Z;Z;Z;Z;Z;Z;Z;Z;Z;Z;Z;Z;Z;Z;Z;Z;Z;Z;Z;Z;Z;Z;Z;Z;Z;Z;Z;Z;Z;Z;Z;Z;Z;Z;Z;Z;Z;Z;Z;Z;Z;Z;Z;Z;Z;Z;Z;Z;Z;Z;Z;Z;Z;Z;Z;Z;Z;Z;Z;Z;Z;Z;Z;Z;Z;Z;Z
Z;Z;Z;Z;Z;Z;Z;Z;Z;Z;Z;Z;Z;Z;Z;Z;Z;Z;Z;Z;Z;Z;Z;Z;Z;Z;Z;Z;Z;Z;Z;Z;Z;Z;Z;Z;Z;Z;Z;Z;Z;Z;Z;Z;Z;Z;Z;Z;Z;Z;Z;Z;Z;Z;Z;Z;Z;Z;Z;Z;Z;Z;Z;Z;Z;Z;Z;0;0;0;0;0;0;Z;Z;Z;Z;Z;Z;Z;Z;Z;Z;Z;Z;Z;Z;Z;Z;Z;Z;Z;Z;Z;Z;Z;Z;Z;Z;Z;Z;Z;Z;Z;Z;Z;Z;Z;Z;Z;Z;Z;Z;Z;Z;Z;Z;Z;Z;Z;Z;Z;Z;Z;Z;Z;Z;Z;Z;Z;Z;Z;Z;Z;Z;Z;Z;Z;Z;Z;Z;Z;Z;Z;Z;Z;Z;Z;Z;Z;Z;Z;Z;Z;Z;Z;Z;Z;Z;Z;Z;Z;Z;Z;Z;Z;Z;Z;Z;Z;Z;Z;Z;Z;Z;Z;Z;Z;Z;Z;Z;Z;Z;Z;Z;Z;Z;Z;Z;Z
Z;Z;Z;Z;Z;Z;Z;Z;Z;Z;Z;Z;Z;Z;Z;Z;Z;Z;Z;Z;Z;Z;Z;Z;Z;Z;Z;Z;Z;Z;Z;Z;Z;Z;Z;Z;Z;Z;Z;Z;Z;Z;Z;Z;Z;Z;Z;Z;Z;Z;Z;Z;Z;Z;Z;Z;Z;Z;Z;Z;Z;Z;Z;Z;Z;Z;Z;Z;Z;0;0;Z;Z;Z;Z;Z;Z;Z;Z;Z;Z;Z;Z;Z;Z;Z;Z;Z;Z;Z;Z;Z;Z;Z;Z;Z;Z;Z;Z;Z;Z;Z;Z;Z;Z;Z;Z;Z;Z;Z;Z;Z;Z;Z;Z;Z;Z;Z;Z;Z;Z;Z;Z;Z;Z;Z;Z;Z;Z;Z;Z;Z;Z;Z;Z;Z;Z;Z;Z;Z;Z;Z;Z;Z;Z;Z;Z;Z;Z;Z;Z;Z;Z;Z;Z;Z;Z;Z;Z;Z;Z;Z;Z;Z;Z;Z;Z;Z;Z;Z;Z;Z;Z;Z;Z;Z;Z;Z;Z;Z;Z;Z;Z;Z;Z;Z;Z;Z;Z;Z
Z;Z;Z;Z;Z;Z;Z;Z;Z;Z;Z;Z;Z;Z;Z;Z;Z;Z;Z;Z;Z;Z;Z;Z;Z;Z;Z;Z;Z;Z;Z;Z;Z;Z;Z;Z;Z;Z;Z;Z;Z;Z;Z;Z;Z;Z;Z;Z;Z;Z;Z;Z;Z;Z;Z;Z;Z;Z;Z;Z;Z;Z;Z;Z;Z;Z;Z;Z;Z;Z;Z;Z;Z;Z;Z;Z;Z;Z;Z;Z;Z;Z;Z;Z;Z;Z;Z;Z;Z;Z;Z;Z;Z;Z;Z;Z;Z;Z;Z;Z;Z;Z;Z;Z;Z;Z;Z;Z;Z;Z;Z;Z;Z;Z;Z;Z;Z;Z;Z;Z;Z;Z;Z;Z;Z;Z;Z;Z;Z;Z;Z;Z;Z;Z;Z;Z;Z;Z;Z;Z;Z;Z;Z;Z;Z;Z;Z;Z;Z;Z;Z;Z;Z;Z;Z;Z;Z;Z;Z;Z;Z;Z;Z;Z;Z;Z;Z;Z;Z;Z;Z;Z;Z;Z;Z;Z;Z;Z;Z;Z;Z;Z;Z;Z;Z;Z;Z;Z;Z;Z
Z;Z;Z;Z;Z;Z;Z;Z;Z;Z;Z;Z;Z;Z;Z;Z;Z;Z;Z;Z;Z;Z;Z;Z;Z;Z;Z;Z;Z;Z;Z;Z;Z;Z;Z;Z;Z;Z;Z;Z;Z;Z;Z;Z;Z;Z;Z;Z;Z;Z;Z;Z;Z;Z;Z;Z;Z;Z;Z;Z;Z;Z;Z;Z;Z;Z;Z;Z;Z;Z;Z;Z;Z;Z;Z;Z;Z;Z;Z;Z;Z;Z;Z;Z;Z;Z;Z;Z;Z;Z;Z;Z;Z;Z;Z;Z;Z;Z;Z;Z;Z;Z;Z;Z;Z;Z;Z;Z;Z;Z;Z;Z;Z;Z;Z;Z;Z;Z;Z;Z;Z;Z;Z;Z;Z;Z;Z;Z;Z;Z;Z;Z;Z;Z;Z;Z;Z;Z;Z;Z;Z;Z;Z;Z;Z;Z;Z;Z;Z;Z;Z;Z;Z;Z;Z;Z;Z;Z;Z;Z;Z;Z;Z;Z;Z;Z;Z;Z;Z;Z;Z;Z;Z;Z;Z;Z;Z;Z;Z;Z;Z;Z;Z;Z;Z;Z;Z;Z;Z;Z
Z;Z;Z;Z;Z;Z;Z;Z;Z;Z;Z;Z;Z;Z;Z;Z;Z;Z;Z;Z;Z;Z;Z;Z;Z;Z;Z;Z;Z;Z;Z;Z;Z;Z;Z;Z;Z;Z;Z;Z;Z;Z;Z;Z;Z;Z;Z;Z;Z;Z;Z;Z;Z;Z;Z;Z;Z;Z;Z;Z;Z;Z;Z;Z;Z;Z;Z;Z;Z;Z;Z;Z;Z;Z;Z;Z;Z;Z;Z;Z;Z;Z;Z;Z;Z;Z;Z;Z;Z;Z;Z;Z;Z;Z;Z;Z;Z;Z;Z;Z;Z;Z;Z;Z;Z;Z;Z;Z;Z;Z;Z;Z;Z;Z;Z;Z;Z;Z;Z;Z;Z;Z;Z;Z;Z;Z;Z;Z;Z;Z;Z;Z;Z;Z;Z;Z;Z;Z;Z;Z;Z;Z;Z;Z;Z;Z;Z;Z;Z;Z;Z;Z;Z;Z;Z;Z;Z;Z;Z;Z;Z;Z;Z;Z;Z;Z;Z;Z;Z;Z;Z;Z;Z;Z;Z;Z;Z;Z;Z;Z;Z;Z;Z;Z;Z;Z;Z;Z;Z;Z
Z;Z;Z;Z;Z;Z;Z;Z;Z;Z;Z;Z;Z;Z;Z;Z;Z;Z;Z;Z;Z;Z;Z;Z;Z;Z;Z;Z;Z;Z;Z;Z;Z;Z;Z;Z;Z;Z;Z;Z;Z;Z;Z;Z;Z;Z;Z;Z;Z;Z;Z;Z;Z;Z;Z;Z;Z;Z;Z;Z;Z;Z;Z;Z;Z;Z;Z;Z;Z;Z;Z;Z;Z;Z;Z;Z;Z;Z;Z;Z;Z;Z;Z;Z;Z;Z;Z;Z;Z;Z;Z;Z;Z;Z;Z;Z;Z;Z;Z;Z;Z;Z;Z;Z;Z;Z;Z;Z;Z;Z;Z;Z;Z;Z;Z;Z;Z;Z;Z;Z;Z;Z;Z;Z;Z;Z;Z;Z;Z;Z;Z;Z;Z;Z;Z;Z;Z;Z;Z;Z;Z;Z;Z;Z;Z;Z;Z;Z;Z;Z;Z;Z;Z;Z;Z;Z;Z;Z;Z;Z;Z;Z;Z;Z;Z;Z;Z;Z;Z;Z;Z;Z;Z;Z;Z;Z;Z;Z;Z;Z;Z;Z;Z;Z;Z;Z;Z;Z;Z;Z
Z;Z;Z;Z;Z;Z;Z;Z;Z;Z;Z;Z;Z;Z;Z;Z;Z;Z;Z;Z;Z;Z;Z;Z;Z;Z;Z;Z;Z;Z;Z;Z;Z;Z;Z;Z;Z;Z;Z;Z;Z;Z;Z;Z;Z;Z;Z;Z;Z;Z;Z;Z;Z;Z;Z;Z;Z;Z;Z;Z;Z;Z;Z;Z;Z;Z;Z;Z;Z;Z;Z;Z;Z;Z;Z;Z;Z;Z;Z;Z;Z;Z;Z;Z;Z;Z;Z;Z;Z;Z;Z;Z;Z;Z;Z;Z;Z;Z;Z;Z;Z;Z;Z;Z;Z;Z;Z;Z;Z;Z;Z;Z;Z;Z;Z;Z;Z;Z;Z;Z;Z;Z;Z;Z;Z;Z;Z;Z;Z;Z;Z;Z;Z;Z;Z;Z;Z;Z;Z;Z;Z;Z;Z;Z;Z;Z;Z;Z;Z;Z;Z;Z;Z;Z;Z;Z;Z;Z;Z;Z;Z;Z;Z;Z;Z;Z;Z;Z;Z;Z;Z;Z;Z;Z;Z;Z;Z;Z;Z;Z;Z;Z;Z;Z;Z;Z;Z;Z;Z;Z
Z;Z;Z;Z;Z;Z;Z;Z;Z;Z;Z;Z;Z;Z;Z;Z;Z;Z;Z;Z;Z;Z;Z;Z;Z;Z;Z;Z;Z;Z;Z;Z;Z;Z;Z;Z;Z;Z;Z;Z;Z;Z;Z;Z;Z;Z;Z;Z;Z;Z;Z;Z;Z;Z;Z;Z;Z;Z;Z;Z;Z;Z;Z;Z;Z;Z;Z;Z;Z;Z;Z;Z;Z;Z;Z;Z;Z;Z;Z;Z;Z;Z;Z;Z;Z;Z;Z;Z;Z;Z;Z;Z;Z;Z;Z;Z;Z;Z;Z;Z;Z;Z;Z;Z;Z;Z;Z;Z;Z;Z;Z;Z;Z;Z;Z;Z;Z;Z;Z;Z;Z;Z;Z;Z;Z;Z;Z;Z;Z;Z;Z;Z;Z;Z;Z;Z;Z;Z;Z;Z;Z;Z;Z;Z;Z;Z;Z;Z;Z;Z;Z;Z;Z;Z;Z;Z;Z;Z;Z;Z;Z;Z;Z;Z;Z;Z;Z;Z;Z;Z;Z;Z;Z;Z;Z;Z;Z;Z;Z;Z;Z;Z;Z;Z;Z;Z;Z;Z;Z;Z
Z;Z;Z;Z;Z;Z;Z;Z;Z;Z;Z;Z;Z;Z;Z;Z;Z;Z;Z;Z;Z;Z;Z;Z;Z;Z;Z;Z;Z;Z;Z;Z;Z;Z;Z;Z;Z;Z;Z;Z;Z;Z;Z;Z;Z;Z;Z;Z;Z;Z;Z;Z;Z;Z;Z;Z;Z;Z;Z;Z;Z;Z;Z;Z;Z;Z;Z;Z;Z;Z;Z;Z;Z;Z;Z;Z;Z;Z;Z;Z;Z;Z;Z;Z;Z;Z;Z;Z;Z;Z;Z;Z;Z;Z;Z;Z;Z;Z;Z;Z;Z;Z;Z;Z;Z;Z;Z;Z;Z;Z;Z;Z;Z;Z;Z;Z;Z;Z;Z;Z;Z;Z;Z;Z;Z;Z;Z;Z;Z;Z;Z;Z;Z;Z;Z;Z;Z;Z;Z;Z;Z;Z;Z;Z;Z;Z;Z;Z;Z;Z;Z;Z;Z;Z;Z;Z;Z;Z;Z;Z;Z;Z;Z;Z;Z;Z;Z;Z;Z;Z;Z;Z;Z;Z;Z;Z;Z;Z;Z;Z;Z;Z;Z;Z;Z;Z;Z;Z;Z;Z
Z;Z;Z;Z;Z;Z;Z;Z;Z;Z;Z;Z;Z;Z;Z;Z;Z;Z;Z;Z;Z;Z;Z;Z;Z;Z;Z;Z;Z;Z;Z;Z;Z;Z;Z;Z;Z;Z;Z;Z;Z;Z;Z;Z;Z;Z;Z;Z;Z;Z;Z;Z;Z;Z;Z;Z;Z;Z;Z;Z;Z;Z;Z;Z;Z;Z;Z;Z;Z;Z;Z;Z;Z;Z;Z;Z;Z;Z;Z;Z;Z;Z;Z;Z;Z;Z;Z;Z;Z;Z;Z;Z;Z;Z;Z;Z;Z;Z;Z;Z;Z;Z;Z;Z;Z;Z;Z;Z;Z;Z;Z;Z;Z;Z;Z;Z;Z;Z;Z;Z;Z;Z;Z;Z;Z;Z;Z;Z;Z;Z;Z;Z;Z;Z;Z;Z;Z;Z;Z;Z;Z;Z;Z;Z;Z;Z;Z;Z;Z;Z;Z;Z;Z;Z;Z;Z;Z;Z;Z;Z;Z;Z;Z;Z;Z;Z;Z;Z;Z;Z;Z;Z;Z;Z;Z;Z;Z;Z;Z;Z;Z;Z;Z;Z;Z;Z;Z;Z;Z;Z
Z;Z;Z;Z;Z;Z;Z;Z;Z;Z;Z;Z;Z;Z;Z;Z;Z;Z;Z;Z;Z;Z;Z;Z;Z;Z;Z;Z;Z;Z;Z;Z;Z;Z;Z;Z;Z;Z;Z;Z;Z;Z;Z;Z;Z;Z;Z;Z;Z;Z;Z;Z;Z;Z;Z;Z;Z;Z;Z;Z;Z;Z;Z;Z;Z;Z;Z;Z;Z;Z;Z;Z;Z;Z;Z;Z;Z;Z;Z;Z;Z;Z;Z;Z;Z;Z;Z;Z;Z;Z;Z;Z;Z;Z;Z;Z;Z;Z;Z;Z;Z;Z;Z;Z;Z;Z;Z;Z;Z;Z;Z;Z;Z;Z;Z;Z;Z;Z;Z;Z;Z;Z;Z;Z;Z;Z;Z;Z;Z;Z;Z;Z;Z;Z;Z;Z;Z;Z;Z;Z;Z;Z;Z;Z;Z;Z;Z;Z;Z;Z;Z;Z;Z;Z;Z;Z;Z;Z;Z;Z;Z;Z;Z;Z;Z;Z;Z;Z;Z;Z;Z;Z;Z;Z;Z;Z;Z;Z;Z;Z;Z;Z;Z;Z;Z;Z;Z;Z;Z;Z
Z;Z;Z;Z;Z;Z;Z;Z;Z;Z;Z;Z;Z;Z;Z;Z;Z;Z;Z;Z;Z;Z;Z;Z;Z;Z;Z;Z;Z;Z;Z;Z;Z;Z;Z;Z;Z;Z;Z;Z;Z;Z;Z;Z;Z;Z;Z;Z;Z;Z;Z;Z;Z;Z;Z;Z;Z;Z;Z;Z;Z;Z;Z;Z;Z;Z;Z;Z;Z;Z;Z;Z;Z;Z;Z;Z;Z;Z;Z;Z;Z;Z;Z;Z;Z;Z;Z;Z;Z;Z;Z;Z;Z;Z;Z;Z;Z;Z;Z;Z;Z;Z;Z;Z;Z;Z;Z;Z;Z;Z;Z;Z;Z;Z;Z;Z;Z;Z;Z;Z;Z;Z;Z;Z;Z;Z;Z;Z;Z;Z;Z;Z;Z;Z;Z;Z;Z;Z;Z;Z;Z;Z;Z;Z;Z;Z;Z;Z;Z;Z;Z;Z;Z;Z;Z;Z;Z;Z;Z;Z;Z;Z;Z;Z;Z;Z;Z;Z;Z;Z;Z;Z;Z;Z;Z;Z;Z;Z;Z;Z;Z;Z;Z;Z;Z;Z;Z;Z;Z;Z
