1;1;1;1;1;1;1;1;1;1;1;1;1;1;1;1;1;1;1;1;1;1;1;1;0;0;0;0;1;1;1;1;1;1;1;1;1;1;1;1
1;1;1;1;1;1;5;5;5;5;1;1;1;1;1;1;1;1;1;1;1;1;1;1;0;0;0;0;1;1;h;h;h;h;h;1;1;1;1;1
1;1;1;1;1;5;5;0;0;5;0;0;0;0;1;1;1;1;1;1;1;1;1;1;0;0;0;0;1;1;h;h;h;h;h;h;1;1;1;1
1;1;1;1;0;5;0;0;0;0;0;0;0;0;0;0;0;1;1;1;1;1;1;1;0;0;0;0;0;1;h;h;h;h;h;h;1;1;1;1
1;1;1;1;0;0;0;0;0;0;0;0;0;0;0;0;0;0;1;1;1;1;1;1;0;0;0;0;0;0;0;0;0;0;0;1;1;1;1;1
1;1;1;0;0;0;0;0;0;0;0;0;0;0;0;0;0;0;1;1;1;1;1;1;0;0;0;0;0;0;0;0;0;0;0;0;1;1;1;1
1;1;1;0;0;0;0;0;0;0;0;0;0;0;0;0;0;0;1;1;1;1;1;1;1;0;0;0;0;0;0;0;0;0;0;0;1;1;1;1
1;1;1;0;0;0;0;0;0;0;0;0;0;0;0;0;0;0;0;0;0;1;1;1;1;0;0;0;0;0;0;0;0;0;0;0;0;1;1;1
1;1;1;1;0;0;0;0;0;h;h;0;0;0;0;0;0;0;0;0;0;0;0;1;1;1;1;0;0;0;0;0;0;0;0;0;0;1;1;1
1;1;1;1;h;5;0;0;5;h;h;h;0;0;0;0;0;0;0;0;0;0;0;0;1;1;h;h;h;0;0;0;0;0;0;0;0;1;1;1
1;1;1;1;h;h;5;5;5;h;h;h;0;0;0;0;0;0;0;0;0;0;0;0;0;0;h;h;h;h;0;0;0;0;0;0;0;1;1;1
1;1;1;1;h;h;h;h;h;h;h;h;1;0;0;0;0;0;0;0;0;0;0;0;0;0;h;h;h;h;0;0;0;0;0;0;0;1;1;1
1;1;1;1;1;h;h;h;h;h;h;1;1;0;0;0;0;0;0;0;0;0;0;0;0;0;h;h;h;h;0;0;0;0;0;0;0;1;1;1
1;1;1;1;1;1;1;1;1;1;1;1;1;0;0;0;0;0;0;0;0;0;0;0;0;0;0;h;h;h;1;0;0;0;0;0;0;1;1;1
1;1;1;1;1;0;0;1;1;1;1;1;1;0;0;0;0;0;0;0;0;0;0;0;0;0;0;1;1;1;1;0;0;0;0;0;1;1;1;1
1;1;1;1;0;0;0;0;0;1;1;1;1;0;0;0;0;0;0;0;0;0;0;0;0;0;0;1;1;1;1;0;0;0;0;0;1;1;1;1
1;1;1;1;0;0;0;0;0;0;1;1;1;1;0;0;0;0;0;0;0;0;0;0;0;0;0;0;1;1;1;0;0;0;0;h;h;h;h;1
1;1;1;1;0;0;0;0;0;0;1;1;1;1;0;0;0;0;0;0;0;0;0;0;0;0;0;0;1;1;1;0;0;0;0;h;h;h;h;1
1;1;1;1;0;0;0;0;0;0;1;h;h;h;h;0;0;0;0;0;0;0;0;0;0;0;0;0;1;1;1;0;0;0;0;h;h;h;h;1
1;1;1;1;0;0;0;0;0;1;1;h;h;h;h;0;0;0;0;0;0;0;0;0;0;0;0;0;1;1;0;0;0;0;0;h;h;h;1;1
1;1;1;1;1;0;0;0;0;1;1;1;h;h;h;0;0;0;0;0;0;0;0;0;0;0;0;0;1;1;0;0;0;0;0;h;h;h;1;1
1;1;1;1;1;1;1;1;1;1;1;1;1;1;1;0;0;0;0;0;0;0;0;0;0;0;0;0;0;1;0;0;0;0;0;1;1;1;1;1
1;1;1;1;1;1;1;1;1;1;1;1;1;1;1;0;0;0;0;0;0;0;0;0;0;0;0;0;0;1;0;0;0;0;0;1;1;1;1;1
1;1;1;1;1;1;1;1;1;1;1;1;1;1;1;0;0;0;0;0;0;0;0;0;0;0;0;0;0;0;0;0;0;0;0;0;1;1;1;1
1;1;1;1;1;1;1;1;1;1;1;1;1;1;1;0;0;0;0;0;0;0;0;0;0;0;0;0;0;0;0;0;0;0;0;0;1;1;1;1
1;1;1;1;1;1;1;1;1;1;1;1;1;1;1;1;0;0;0;0;0;0;0;0;0;0;0;0;0;0;0;0;0;0;0;0;1;1;1;1
1;1;1;h;h;h;h;h;1;1;1;1;1;1;1;1;0;0;0;0;0;0;0;0;0;0;0;0;0;0;0;0;0;0;0;0;0;1;1;1
1;1;1;h;h;h;h;h;1;1;1;1;1;1;1;1;0;0;0;0;0;0;0;0;0;0;0;0;0;0;0;0;0;0;0;0;0;1;1;1
1;1;1;h;h;h;h;h;h;h;h;h;h;1;1;1;0;0;0;0;0;0;0;0;0;0;0;0;0;0;0;0;0;0;0;0;0;1;1;1
1;1;1;h;h;h;h;h;h;h;h;h;h;1;1;1;0;0;0;0;0;0;0;0;0;0;0;0;0;0;0;0;0;0;0;0;0;1;1;1
1;1;1;1;1;h;h;h;h;h;h;h;h;1;1;1;1;0;0;0;0;0;0;0;0;0;0;0;0;0;0;0;0;0;0;0;0;1;1;1
1;1;1;1;1;h;h;h;h;h;h;h;h;1;1;1;1;0;0;0;0;0;0;0;0;0;0;0;h;h;h;0;0;0;0;0;0;1;1;1
1;1;1;1;1;1;1;1;1;1;1;1;1;1;1;1;1;0;0;0;0;0;0;0;0;0;0;h;h;h;h;0;0;0;0;0;0;1;1;1
1;1;1;1;1;1;1;1;1;1;1;1;1;1;1;1;1;1;0;0;0;0;0;0;0;0;0;h;h;h;h;0;0;0;0;0;1;1;1;1
1;1;1;1;1;1;1;1;1;1;1;1;1;1;1;1;1;1;1;1;0;0;0;0;0;0;1;1;1;1;0;0;0;0;0;0;1;1;1;1
1;1;1;1;1;1;1;1;1;1;1;1;1;1;1;1;1;1;1;1;1;1;1;1;1;1;1;1;1;1;0;0;0;0;1;1;1;1;1;1
1;1;1;1;1;1;1;1;1;1;1;1;1;1;1;1;1;1;1;1;1;1;1;1;1;1;1;1;1;1;0;0;0;0;1;1;1;1;1;1
